a: um, uma
a lot of: muito
abacus: ábaco
aback: atrás, detrás
abaft: pôpa, atrás
abalone: molusco da califórnia
abandon: abandone, abandonar
abandoned: abandonado
abandonment: abandono
abase: rebaixe, rebaixar
abasement: rebaixamento, degradação
abash: confunda
abashed: confundido, envergonhado, embaraçado
abate: diminua
abatement: abatimento, redução
abbattoir: matadouro
abbess: abadessa
abbey: abadia
abbot: abade
abbreviate: abrevie, abreviar
abbreviation: abreviatura
abbreviatiatory: que abrevia
abc: abc, alfabeto
abdicant: abdicante, renunciante
abdicate: abdique, abdicar
abdication: abdicação, renúncia
abdomen: ventre, abdômen
abdominal: abdominal
abduce: abduza, abduzir
abduct: arrebate, arrebatar
abed: na cama, deitado
aberr: desvie-se, desviar-se
aberrant: aberrante, anormal
aberration: erro, aberração, defeito
abet: incitar, instigar, ajudar
abetment: incitamento, instigação
abetter: cúmplice
abettor: cúmplice
abeyance: expectativa
abhor: abominar, destestar
abhorrence: aversão
abhorrent: repugnante
abide: habitar, padecer, esperar
ability: abilidade
ablaze: em chamas
able: capaz
able-bodied: são
abnegate: abnegue, abnegar
abnormal: anormal
aboard: a bordo de
abode: domicílio, aposento
abort: aborto
about: à cerca de, sobre
about-face: meia volta
above: sobre, acima
above-board: às claras
above-mentioned: supra mencionado
above all: principalmente, sobretudo
above ground: acima do chão
abrasion: abrasão
abrasive: abrasivo
abreast: lado a lado
abroad: no exterior
abrogate: revogue, revogar
abrupt: abrupto
abruptly: abruptamente
abscond: evada-se, evadir-se
absence: ausência
absent: ausente
absent-minded: distraído
absent oneself: afaste-se, afastar-se
absentee: absentista
absenteeism: absentismo
absolute: absoluto
absolutely: deveras, absolutamente, verdadeiramente
absorb: absorva, absorver
absorbent: absorvente
absorbing: absorver
abstract: sumário
abstracted: abstraído
abstraction: abstração, descuido, furto
absurd: absurdo
abundance: abundância
abundant: abundante
abundantly: em abundância
abuse: abuso
abusive: abusivo
abut: confim, confrontar com
abutment: limite
academic: acadêmico
academy: academia
accede: consinta, consentir, concorde, concordar
accelerate: acelere, acelerar
accent: acento, ênfase
accept: aceite, aceitar
acceptability: aceitabilidade
acceptable: aceitável
acceptance: aceitação
acceptancy: aceite, aceitação
acceptation: aceitação, acepção
accepted: aceitado
acceptor: aceitador
access: acesso, ataque
accessible: acessível
accessibility: acessibilidade
accession: acessão, acesso
accessories: acessórios
accessory: acessório
accident: acidente
accident-prone: muito sujeito a acidentes
accidental: acidental
acclimatize: aclimate, aclimatizar
accommodate: acomode, acomodar
accommodating: acomodador, complacente
accommodation: aposento, acomodação
accomodate: acomode, acomodar
accomodation: acomodação
accompaniment: acompanhamento
accompany: acompanhe, acompanhar
accompanying: acompanhar
accomplice: cúmplice
accomplish: realize, realizar
accord: acordo
accordion: acordeão, acordeon
accost: abordar alguém
account: conta, relato
accountability: dever, responsabilidade
accountable: responsável
accountant: contabilista, guarda-livros
accredit: acredite, acreditar
accumulate: acumule, acumular
accumulator: acumulador
accuracy: exatidão
accurate: exato
accurse: amaldiçoe, amaldiçoar
accusation: acusação
accusatory: acusatório
accuse: culpe, culpar, acuse, acusar
accused: acusado
accustom: acostume, acostumar
acetate: acetato
acetic: acético
acetone: acetona
acetylene: acetileno
ache: dor, doer
achievable: exequível, factível
achieve: consiga, conseguir, complete, completar
acid: ácido
ack-ack: metralhadora de avião
acknowledge: reconheça, reconhecer
acknowledgement: reconhecimento
acme: cume, ápice
acne: acne, pústula
acolyte: acólito
acorn: bolota
acoustic: acústico
acoustics: acústica
acquaint: conheça, conhecer
acquaintance: conhecimento, familiaridade
acquire: adquira, adquirir, obtenha, obter
acquired: adquirido
acquisition: aquisição
acronym: acrônimo
across: através de
across from: contra, oposto
act: fazer, ato
action: ação, acão, façanha
active: ativo
activist: ativista
activity: atividade
actor: ator
actress: atriz
actual: atual, real
actually: atualmente, realmente
actuary: atuário
acute: agudo
ad: anúncio
adapt: adapte, adaptar
adaptation: adaptação
adapted: adaptado
adapter: adaptador
adaptor: adaptador
add: adicione, adicionar
addition: adição
additional: adicional
address: endereço
addressee: destinatário
addressing-machine: máquina de endereçar
adept: perito
adequate: adequado
adherent: aderente
adhesion: adesão
adieu: adeus
adipose: adiposo
adjacency: adjacência
adjacent: adjacente
adjectival: adjetival
adjective: adjetivo
adjoin: junte-se, juntar-se
adjourn: adiar
adjudge: adjudicar
adjudgement: adjudicação
adjunct: adjunto
adjust: ajuste, ajustar
adjusted: ajustado
adjustment: ajuste
administer: administre
administration: administração
administrative: administrativo
administrator: administrador
admirable: admirável
admiral: almirante
admiration: admiração
admire: admire, admirar
admirer: admirador
admiring: admirável, admirar
admission: admissão
admission ticket: bilhete de ingresso
admit: admita
admitable: admissível
ado: ruído
adolescence: adolescência
adolescent: adolescent
adopt: adoptar, adote
adopted: adotado
adoption: adoção
adorable: adorável
adoration: adoração
adore: adore, adorar
adornment: adorno
adown: em baixo, abaixo
adroit: reto, direito, hábil
adroitness: habilidade
adrenaline: adrenalina
Adriatico: Adriático
adulation: adulação
adulatory: adulador
adult: adulto
adulterate: adulterado
adultery: adultério
advance: avance, avançar, avanço
advantage: vantagem
advantageous: vantajoso
adventure: aventura
adverb: advérbio
adversary: adversário
advertise: anuncie
advertisement: anúncio, propaganda
advice: conselho
advisable: aconselhável
advise: recomende, aconselhar
advocate: advogado
aerate: ventile
aeroplane: avião
affair: caso, assunto
affect: afete
affected: afetado
affection: afeição
affiliate: filial
affinity: afinidade
Afghanistan: Afeganistão
afield: no campo
afraid: receoso
Africa: África
African: Africano
after: depois, em seguida, trás
afternoon: tarde
afterward: em seguida, depois, mais tarde
afterwards: em seguida, depois, mais tarde
again: outra vez
against: contra, de encontro
agar: ágar
agar-agar: ágar-ágar, geléia de algas
age: idade
aged: envelhecido
agency: agência
agenda: agendas
agent: agente
agglomerate: aglomerado
aggregate: agregado
aggressor: agressor
agitate: agite
agitated: agitado
agony: agonia
agree: concorde, concordar
agreed: concordado
agreement: acordo
agriculture: agricultura
agriculturist: agricultor
ahead: antes, diante, adiante
aid: ajudar
aide-de-camp: ajudante-de-campo
aim: alvo
air: ar
air-balloon: ar de balão
air-conditioning: condicionamento de ar
air-crew : tripulação
air-cushion: almofada de ar
air-defence: defesa aérea
air-filter: filtro de ar
air-fleet: frota aérea
air-grid: ar-grade
air-gun: ar-injetor
air-hostess : aeromoça
air-mail: correio aéreo
air-plane: avião
air-pocket: bolsão de ar
air-pollution: poluição atmosférica
air-resistance: resistência aérea
air-ship: dirigível
air-squadron: esquadrão aéreo
air-valve: válvula de ar
aircraft: avião, aeroplano
airfield: aeródromo
airline-pilot: piloto de linha aérea
airplane: avião, aeroplano
airport: aeroporto
alarm: alarme
alarm clock: despertador
Albania: Albânia
alcohol: álcool
alcoholic: alcoólico
alderman: vereador
ale: cerveja inglêsa, cerveja
alert: alerta
algebra: álgebra
Algeria: Algéria, Argélia
Algiers: Argel
algorithm: algoritmo
alien: estrangeiro
alive: vivo
all: todo, tudo
all of a sudden: subitamente
allegedly: alegada
alley: beco, aléia
alligator: jacaré
allot: distriba
allow: reserve
alloy: iga
alluring: fascinar
almond: amêndoa
almost: quase
alone: sozinho
along: ao longo
alongside: ao lado de
alp: alpes
alphabet: alfabeto
Alps: alpes
already: já
Alsace: Alsácia
Alsace-Lorraine: Alsácia-Lorena
also: também
alter: altere
alternate: substituição
alternating: alternar
alternative: alternativa
although: embora
altitude: altura, altitude
altogether: tudo, completamente
aluminium: alumínio
aluminum: alumínio
always: sempre
amateur: amador
amaze: espante
amazing: espantar-se
Amazon: Amazonas
ambassador: embaixador
ambition: ambição
ambitious: ambicioso
ambulance: ambulância
America: América
American: Americano
amidst: entre
ammunition: munição
among: entre
amount: uma quantidade
ampere: ampère
ample: amplo
amputate: ampute
Amsterdam: Amsterdã
amuse: divirta
amusement: divertimento
amusing: divertir
analyse: analise
analysis: análise
analytic: analítico
analytical: analítico
analyze: analise
anchor: âncora, escora
anchovy: anchova
ancient: antigo
and: e
angel: anjo
anger: raiva
angle: ângulo
angry: irritado
animal: animal
Ankara: Ancara
ankle: tornozelo
annotation: anotação
announce: anuncie
announcement: anúncio
announcer: anunciador
annoy: irrite
annual: anual
another: outro, outros
answer: responder, resposta
ant: formiga
antelope: antílope
antenna: antena
anthropologist: antropólogo
anti-freeze: anticongelante
anticipate: antecipe
Antilles: Antilhas
antique: antigo
Antwerp: Antuérpia
anvil: batente
anxious: ansioso
anxiously: ansiosamente
any: quem quer, alguém, alguns
anybody: alguém, qualquer um
anything: qualquer coisa, algo
anywhere: em qualquer lugar
apart: distante
apartment: apartamento
ape: macaco
ape-like: macacóide
aperture: abertura
apologize: desculpe-se
apology: satisfação
apostrophe: apóstrofe
apparatus: instrumento, aparelho
apparent: aparente
apparently: evidentemente, aparentemente
appeal: apelação
appear: aparecer, apareça
appearance: aparência
appellation: nome
appendix: apêndice
appetite: apetite
applaud: aplauda
apple: maçã
apple-tree: macieira, arvore de maçã
applicant: pretendente
application: aplicação
apply: aplique
appoint: aponte
appointment: nomeação
appraise: orçar, avaliar
appraiser: avaliador
appreciate: aprecie
approach: aproximação
appropriate: apropriado
appropriately: apropriadamente
approval: aprovação
approve: aprove
approximate: aproxime
approximately: cerca, aproximadamente
apricot: Damasco, alperce
April: Abril
apron: avental
aptitude: aptidão
aquarium: aquário
aquatic: aquático
Arab: Árabe
Arabia: Arábia
Arabic: Árabe
arbiter: árbitro
arbitrarily: arbitrariamente
arbitrary: arbitrário
arbitrator: árbitro
arbor: mandril
arc: arco
arch-: arco, arqui-
arch-enemy: satanás, inimigo principal
archipelago: arquipélago
architect: arquiteto
archive: arquivo
archives: papéis velhos, arquivos
archivist : arquivista
Arctic: Ártico
are: seja, ser
area: área
Argentina: Argentina
Argentine: argentino, Argentina
argue: discuta
arise: nascer, levante-se
arithmetic: aritmética
arm: braço
arm-chair: poltrona
armchair: poltrona
Armenia: Armênia
army: exército
around: em torno
arouse: desperte
arrange: arranje, arranjar
arrangement: arranjo
arrears: atrasos
arrest: apreensão
arrival: chegada
arrivals: chegadas
arrive: chegue
arrogant: arrogante
arrow: seta
art: arte
artery: artéria
artichoke: alcachofra
article: artigo, objeto
artillery: artilharia
artist: artista
artistic: artístico
as: quão, como
ascertain: verifique
ash: cinza, freixo
ash-tray: cinzeiro
Asia: Ásia
Asian: asiático
ask: rogar, perguntar, peça
ask for: rogar
asleep: adormecido
asparagus: espargo, espargos
aspect: aspecto
aspen: álamo tremedor
asphalt: asfalto
aspirin: aspirina
ass: burro
assailant: assaltante
assault: assalto
assemble: monte
assembler: ajuntador
assembly: conjunto
assert: afirme
assessment: avaliação
asset: recurso
assets: recursos
assign: atribua
assigned job: tarefa
assist: ajudar, assistência
assistant: assistente
associate: associado
association: associação
Assumption: Suposição
assure: assegure
asterisk: asterisco
astronaut: astronauta
astronomer: astrônomo
astronomy: astronomia
Asturias: A Astúrias
at: em
at last: finalmente
at once: diretamente
at present: ora, agora
Athens: Atenas
athlete: atleta
athletic: atlético
Atlantic: Atlântico
Atlantic Ocean: Oceano Atlântico
atmosphere: atmosfera
atom: átomo
atomic: atômico
attach: anexo
attachment: acessório
attack: ataque
attacker: atacante
attain: adquirir, alcance, obter
attempt: esforço, tentativa, provar
attend: atenda
attendant: assistente
attention: atenção
attenuate: atenue
attest: ateste
Attic: Sótão
attitude: atitude
attract: atraia
attraction: atração
attractive: atrativo
attribute: atributo
aubergine: berinjela, beringela
audience: audiência
audit: exame
auditor: revisor de contas
augment: aumente
August: Agosto
aunt: tia
Australia: Austrália
Austria: Áustria
Austrian: austríaco
author: autor
authority: autoridade
authorization: autorização
authorize: autorize
automatic: automático
automobile: automóvel
autonomous: autônomo
autumn: outono
available: disponível
avenue: avenida
average: média
aviation: aviação
aviator: aviador
avoid: evite, evitar
await: esperar, espere
awake: acorde
aware: ciente
awareness: consciência
away: afastado, longe
awful: terrível
awkward: inábil
axe: machado
axis: linha central, eixo
axle: eixo
Azores : Açores
baboon: babuíno
baby: bebê
babysitter: baby-sitter, babá
back: dorso, parte traseira
background: fundo
backside: parte traseira
backspace: retrocesso
backup: apoio
backward: para trás
backwards: para trás
bacon: toucinho, toicinho
bacterium: bactéria
bad: mau
bad-smelling: mau cheiro
badge: emblema
badger: texugo
badly: mal
bag: saco
baggage: bagagem
Baghdad: Bagdá
bake: coza
baker: padeiro
bakery: padaria
balance: contrapeso
balcony: balcão
Balkans: Balcãs
ball: esfera, bola
ballast: reator
balloon: balão
Baltic: Báltico
Baltic Sea: Mar Báltico
bamboo: bambu
banana-plant: bananeira
band: faixa
bandit: bandido
bang: estrondo
Bangkok: Banguecoque
bank: margem, banco
bank-note: nota de banco
banknote: nota de banco
bankrupt: falido
banner: bandeira
banquet-room: sala de banquete
bar: barra
barbed-wire: arame farpado
barber: barbeiro, cabeleireiro
bare: nu, desencapado
barely: apenas, mal
bargain: negócio
barge: barcaça, lancha
bark: casca
barley: cevada
barn: celeiro
barometer: barômetro
barracks: quartel
barrel: tambor
barrier: barreira
bartender: bárman
Basel: Basiléia
basement: cave, porão, subsolo
basic: básico
basin: tijela, bacia
basis: base
basket: cesta, cesto
bass: baixo
bat: bastão
bath: banho
bathe: banhe, banhar-se
bathing : banho
bathing-suit: roupa de banho
bathroom: banheiro
baton: vara
battery: bateria
battle: batalha
bay: baía
bayonet: baioneta
be: estar, seja, ser
be afraid of: recear, temer
be alive: viver
be asleep: dormir
be born: nascer
be lacking: faltar
be married: casar-se
be missing: faltar
be quiet: calar-se
beach: praia
bead: grânulo
beak: bico
beam: feixe
bean: fava, feijão
bear: urso, padecer
beard: barba
bearing: rolamento
beast: besta
beat: bater, batida
beautiful: belo, bonito, formoso
beautifully: belamente
beauty: beleza
beaver: castor
because: porque
become: acontecer, tornado
becoming: tornar-se
bed: cama
bee: abelha
bee-keeper: apicultor
beech: faia
beef: carne
beer: cerveja
beet: beterraba
beetle: besouro
before: antes
beg: rogar, implore
beggar: mendigo, pedinte
begin: comece, começar, iniciar
beginner: novato
beginning: princípio, começo
behave: comporte-se
behaviour: conduta, comportamento
behind: trás, atrás de
beige: bege
Beirut: Beirute
Belgian: Belga
Belgium: Bélgica
Belgrade: Belgrado
belief: opinião, crença
believe: acreditar, acredite, crer
bell: sino, campainha
belly: barriga, ventre
belong to: pertencer
below: abaixo, sob
belt: correia, cinto
bench: banco
bend: curvatura
beneath: abaixo de, sob
Benedictine: Beneditino
benefit: benefício
bengal-lights: bengal-luzes
benign: benígno
bent: curvado
Berlin: Berlim
Bern: Berna
berry: baga
beside: ao lado de
besides: adicionalmente, demais
best: melhor
bet: aposta
better: melhor
between: entre
beverage: bebida
beyond: além, além de
biased: inclinado
bibliography: bibliografia
bicycle: bicicleta
bid: rogar, oferta
big: grande
bike: bicicleta
bill: fatura, bico, conta, bilhete
binary: binário
bind: ligar, ligamento
binding: ligar
binoculars: binóculos
biologist: biólogo
birch: vidoeiro
bird: pássaro
birds: pássaros
birth: nascimento
birthday: aniversário
biscuit: biscoito
bison: bisonte
bit: bocado
bite: mordida
bitter: amargo
black: preto, negro
blackberry: amora
blackbird: melro, toutinegra
blackness: obscuridade
bladder: bexiga
blade: lâmina
blame: culpar, culpa
blameworthy: censurável
blank: espaço em branco, branco
blanket: cobertor
bleak: frio
bleed: sangramento
bleeding: sangramento
blend: mistura
blind: cortina, cego
blink: piscamento
blister: bolha
block: bloco
blood: sangue
blood-letting: sangria
blood-red: sangue-vermelho
bloody: sangrento
bloom: flor
blossom: flor
blot: borrão
blouse: blusa
blow: soprar, sopro
blue: azul
blunt: sem corte
blur: borrão
board: placa
boarding house: pensão
boarding school: pensão
boardroom: sala de reuniões
boat: barco
bobbin: bobina
body: corpo
Bohemia: Boémia
boil: fervura
boiler: caldeira
bold: gordo, bold(realce)
Bolivia: Bolívia
bolt: parafuso
bomb: bomba
bombard: bombardeie
Bombay: Bombaim
bon-bon: bombom
bonbon: bombom
bond: ligação
bone: osso
bonus: bônus
book: livro
booking-office: booking-escritório
booklet: livreto
bookseller: livreiro
bookshop: livraria
boot: bota, carregador
booze: bebidas
borax: bórax
Bordeaux: Bordéus
border: margem, beira
bore: furo, verruma
boring: furar
Borneo: Bornéu
borrow: peça
Bosnia: Bósnia
Bosnian: Bosniano
bosom: seio, peito
boss: amo, saliência
both: ambos
bother: incômodo
bottle: frasco, garrafa
bottom: fundo
bough: ramo
bouillon: caldo de carne
boulder: pedregulho
boulevard: bulevar
boundary: limite
boutique: loja
bovine: Bovídeos
bow: curva, proa
bowl: tijela, bacia
box: caixa
boy: menino, rapaz
Brabant: Rendas do Brabante
brace: cinta
braces: suspensórios, cintas
bracket: suporte
brackets: suportes
braid: trança
brain: cérebro
brake: freio, travão
branch: ramo, filial
brandy: aguardente, conhaque
brass: bronze, latão
Braunschweig: Bransvique
brave: bravo
Brazil: Brasil
Brazilian: brasileiro
breach: ruptura
bread: pão
break: partir-se, ruptura, romper
breakfast: café-da-manhã, pequeno almoço
bream: brema
breast: peito
breath: respiração
breathe: respire
breather: respiradouro
breed: raça
breeze: brisa
Bretagne: Bretanha
Breton: Bretão
brick: tijolo
bridge: ponte
bridle: breio
brief: sumário
briefcase: pasta
briefs: sumário
bright: brilhante
brilliant: brilhante
bring: traga
brisk: vivo
bristle: cerda
Britain: Grã-Bretanha, Grã Bretanha
British: Britânico
Briton: Britânico
Brittany: Bretanha
brittle: frágil
broad: largo, amplo
broadcast: transmissão
broccoli: bróculos
broken: quebrado
broker: corretor
brokerage: agência corretora
brook: ribeiro
broom: vassoura
brother: irmão
brow: sobrancelha, testa
brown: marrom
Brunswick: Brunsvique
brush: escova
Brussels: Bruxelas
Brussels-sprouts: Bruxelas-brussels-sprouts
brute: bruto
bubble: bexiga, bolha
Bucharest: Bucareste
bucket: balde, cubeta
buckle: curvatura
buddy: camarada
budget: orçamento
buffalo: búfalo
buffer: amortecedor
buffet: bufete
buffoon: bufão, palhaço
bug: inseto, erro, inseto
build: configuração
builder: lavrador, construtor
building: edifício
bulb: lâmpada, bulbo
Bulgaria: Bulgária
bulk: volume
bulky: volumoso
bull: touro
bulldozer: escavadora
bullet: bala
bulletin: boletim
bumblebee: zangão
bump: colisão
bumper: amortecedor
bunch: grupo
bundle: pacote
bungle: estrague
burden: carga
burdensome: pesado
bureau: departamento
burglar: assaltante
Burgundy: Borgonha
burn: queimadura
burnt: queimado
burst: estouro
bury: enterro
bus: barra-ônibus
bush: arbusto
Bushman: Bosquímano
business: comércio, negócio, assunto, transacção
business deal: assunto
businessman: homem de negócios
busy: ocupado
but: mas, embora, contudo
butcher: açougueiro, carniceiro
butter: manteiga
butterfly: borboleta
button: tecla
buy: comprar, compra
buyer: comprador
buzz: zumbido
buzzer: cigarra
by: por
by now: já
bye : adeus, assunto secundário
cab: táxi
cab-stand: táxi-esteja
cabaret: cabaré
cabbage: repolho, couve
cabin: camarote, cabine, cabana
cabinet: armário
cable: cabo
cablegram: cabograma
cactus: cacto
cage: gaiola
Cairo: O Cairo
cake: bolo
calabash: abóbora
calculate: calcule
calculation: conta, cálculo
calculator: calculadora
calendar: calendário
calf: vitela, vitelo, barriga
California: Califórnia
call: nomear, chamar, chamada
caller: chamador
calm: calma
camel: camelo
camera: câmera
Cameroun: República dos Camarões
camp: acampamento
campaign: campanha
camphor: cânfora
can: lata
Canada: Canadá
Canadian: Canadense
Canary: Canário
cancel: cancelamento
candidate: candidato
candle: vela
candy: doce
cane: bastão, vara
cannon: canhão
canteen: cantina
canyon: garganta
cap: barrete, tampão
capability: potencialidade
capable: capaz
caper: alcaparra
capital: importante, capital
capitalist: capitalista
capsule: cápsula
captain: capitão
capture: captação
car: automóvel, carro, auto
caravan: caravana
carbon-paper: carbono-papel
carburettor: carburador
card: cartão
cardboard: cartão
care: cuidado
career: carreira
careful: cuidadoso
carefully: com cuidado
careless: descuidado
cargo: carga
carousel: carrossel
carp: carpa
carpenter: carpinteiro
carpet: tapete
carriage: vagão, carruagem
carrot: cenoura
carrousel: carrossel
carry: carregue
carrying: carregar
cart: carro
cartridge: cartucho
case: caso, assunto
cash: dinheiro
cashew-nut: castanha de caju
cashier: caixa
cassava: mandioca
casserole: caçarola
cassette: gaveta
cast: molde
cast-off: molde-fora
castle: castelo, torre
Castor: Rodízio
cat: gato
catalog: catálogo
catalogue: catálogo
catastrophic: catastrófico
catch: prendedor
catching: travar
category: categoria
caterpillar: lagarta
cathedral: catedral
Caucasus: Cáucaso
cauliflower: couve-flor
caulk: calafete
cause: causar, causa
caution: cuidado
cautious: cauteloso
cavalier: mais cavalier
cavalry: cavalaria
cave: caverna
cavern: caverna
cavity: cavidade
cease: cesse
cedar: cedro
ceiling: teto, teto
celebrate: comemore, festejar
celebrity: celebridade
celery: aipo
cell: pilha
cellar: adega, subsolo, cave
Celsius: Célsio
cement: cimento
cemetery: cemitério
cent: centavo
centavo: centavo
centennial: século
center: centro
centre: centro
century: século
certain: certo
certainly: certamente
certificate: certificado
certify: certifique
Ceylon: Ceilão
Chad: República do Tchad
chain: corrente
chair: cadeira
chairman: presidente
chalk: greda, giz, griz
challenge: desafio
chamber: quarto, câmara
chamber-pot: penico, câmara-potenciômetro
chamois: camurça
champagne: champanhe
champion: campeão
chance: possibilidade
chandelier: mais chandelier
change: troco, mudança
channel: canaleta
chaos: caos
chap: rachadura
chaplain: capelão
chapter: capítulo
character: carácter, caráter
characteristic: característico
characterization: caracterização
characterize: caracterize
charcoal: carvão de lenha
charge: carga
charm: encanto
charter: carta patente
chase: perseguição
chat: bate-papo
chatter: vibração
cheap: barato
cheat: fraude
check: verificação
checked: verificado
checker: verificador, revisor
checkers: verificadores
checksum: soma de controle
cheek: face, mordente
cheese: queijo
chef: chefe
chemist: farmacêutico, químico
chemistry: química
cheque-book: cheque-livro
cherry: cereja
cherry-tree: cerejeira, cereja-árvore
chest: caixa, peito
chestnut: castanha
chestnut-tree: castanheiro, castanha-árvore
chew: mastigação
chewing-gum: pastilha elástica
chick: pintainho
chicken: galinha, frango
chicory: chicória
chief: chefe
chief: chefe
chiefly: principalmente
child: menino, menina, criança
Chile: O Chile
chilli: pimentões
chilly: frio
chimney: chaminé
chimpanzee: chimpanzé
chin: queixo
China: China
Chinese: Chinês
chip: microplaqueta
chirp: chilro
chisel: formão, cinzel
chive: cebolinho
choice: escolha
choke: bloqueador
choose: escolha, escolher
chord: corda
Christian: Cristão
Christmas-tree: Christmas-árvore
chuck: mandril
chunk: pedaço
church: igreja
church-father: igreja-pai
cider: cidra
cigar: charuto
cigar-end: charuto-extremidade
cigar-stub: charuto-topo
cigarette: cigarro
cinder: cinza
cinema: Cinema
cipher: cifra
circle: círculo
circuit: circuito
circulate: circule
circulation: circulação
circumstance: circunstância
circumstances: circunstâncias
citizen: cidadão
city: vila, cidade
civilian: civil
civilization: civilização
claim: reivindicação
clamp: braçadeira
clarify: esclareça
class: classe
classic: clássico
classify: classifique
clatter: tinido
clause: cláusula
claw: garra
clay: argila
clean: limpar, limpo
cleanse: limpar
clear: cancele, claro
clearly: claramente
clergyman: clérigo
clerk: caixeiro
clever: inteligente
click: clique
client: freguês, cliente
cliff: penhasco
climate: clima
climatic: climático
climb: escalada
clinic: clínica
clip: grampo
cloak: casaco
cloakroom: guarda-roupa
clock: relógio
clockwise: no sentido horário
clog: obstrução
close: fim, fechar
closet: armário
cloth: pano
clothe: vista
clothes: roupa, roupas
clothes-press: roupa-pressione
clothing: roupas, roupa
cloud: nuvem
clove-cheese: cravo-da-índia-queijo
clover: trevo
club: clube
clubs: clubes
cluster: conjunto
clutch: embreagem
co-operate: coopere
co-ordinate: coordene
coach: vagão, carruagem, ônibus
coach-work: ônibus-trabalhe
coal: carvão
coarse: grosseiro
coast: costa
coat: revestimento
cocaine: cocaína

cock: torneira, galo

cockroach: barata

coco-nut: coco
cocoa: cacau
cocoa-nut: cacau-porca
coconut: coco
coconut-palm: coqueiro
cocoon: casulo
cod: bacalhau
code: código
codfish: bacalhau, bacalhaus
codfish-oil: bacalhau-óleo
coffee: café
coffee-pot: café-potenciômetro, cafeteira
coffin: caixão
cognac: aguardente, conhaque
coil: bobina
coin: moeda
coincide: coincida
cold: constipação, resfriado, frio
collapse: colapso
collar: colarinho, colar
colleague: colega
collect: colete, colher
collection: coleção
collective: coletivo
college: faculdade
collide: colida
collision: colisão
Cologne: Colônia
Colombia: Colômbia
colonel: coronel
colony: colônia
color: cor
colour: cor
colour-blind: cor-cego
Columbus: Columbo
column: coluna
comb: pente
combination: combinação
combine: liga, combinar
combustion: combustão
come: vindo
come about: acontecer
come to a halt: parar
comedy: comédia
comfort: conforto
comfortable: cómodo, confortável, cômodo
comfortably: confortavelmente
coming: vinda
comma: vírgula
command: comando, mando, ordem
commander: comandante
commence: comece, iniciar, começar
commencement: começo, princípio
commend: elogíe
comment: comentário
commerce: comércio
commissioner: comissário
committee: comitê
commodity: produto
common: comum
communicate: comunique-se
communication: uma comunicação
communication-cord: comunicação-cabo
communist: comunista
community: comunidade
commute: comute
compact: estojo compacto
companion: companheiro
company: companhia
comparatively: comparativamente
comparison: comparação
compartment: compartimento
compass: compasso, bússola
compatible: compatível
compel: compila
compensate: compense
compensation: compensação, recompensa
compete: compita
competent: competente
competition: competição
compilation: compilação
compiler: compilador
complain: queixe-se
complaint: queixa
complementary: complementar
complete: cheio, completo
completed: terminado
completely: completamente
complex: complexo
complexion: tez
complicate: complique
complicated: complicado
compliment: elogio
compose: componha
composer: compositor
composing: compôr
composition: composição
comprehensive: detalhado
comprehensively: detalhada
compress: compressa
comprise: conter, compreenda
compulsory: compulsório
compute: cálculo
computer: computador
comrade: camarada
concave: côncavo
conceal: esconda
concentrated: concentrado
concept: conceito
concern: interesse
concerned: interessado
concerning: concernir
concert-room: concert-quarto
concise: conciso
conclude: conclua
conclusion: conclusão
concrete: formigão, concreto
condition: circunstância
conduct: conduta
conductor: condutor
conference: conferência
confide: confíe
confidence: confiança
confident: confiável
confined: confinado
confirm: confirme
confirmation: confirmação
conflict: conflito
conform: conforme-se
conforming: conformar-se
confront: confronte
confuse: confunda
confusing: confundir
confusion: confusão
congratulate: felicite
conjunction: junção
connect: ligar, conecte
connection: ligação, conexão
conquer: conquiste
conscientious: consciencioso
consecutively: consecutivamente
consent: consentimento, concordar
consequence: conseqüência
consequently: conseqüentemente
conservative: conservador
consider: considere
considerable: considerável
considerably: consideravelmente
consignee: destinatário, consignatário
consist: consista
consistency: consistência
consistent: consistente
consonant: consoante
constant: constante
constantly: constantemente
constitute: constitua
construct: construção
consul: cônsul
consulate: consulado
contain: conter
continually: continuamente
continuation: continuação
continuous: contínuo
continuously: continuamente
contour: contorno
contract: contrato
contractor: contratante
contrary: contrário
contrast: contraste
contribute: contribua
contribution: contribuição
control: reger, controle
controller: controlador, revisor
controversy: controvérsia
convenient: conveniente
convention: convenção
converge: convirja
conversation: conversação
converse: inverso
convert: converso
convey: faça saber
conviction: convicção
convince: convença
cook: cozinheiro, cozinheira
cooked: cozinhado
cool: fresco
coop: gaiola
cooperate: coopere
coordinate: coordenada
Copenhagen: Copenhaga
coping: lidar
copper: cobre
copy: cópia
copyright: direitos reservados
cord: cabo, corda
core: núcleo
cork: cortiça
cork-screw: saca-rolhas
corkscrew: saca-rolhas
corn: milho
corner: canto
corporal: cabo
corps: corpo
corpulent: gordo
corral: cerca
correct: correto
correspond: corresponda
corridor: corredor
corridor-train: corredor-treine
corrode: corroa
corrugate: corrugue
Corsica: Córsega
cost: custo, custar
costly: caro
costume: traje
cottage: casa de campo
cotton: algodão
couch: divã
couch-grass: couch-grama
council: conselho
counsel: conselhos, conselho, aconselhar
counsellor: conselheiro
count: contagem
counterfeit: moeda falsa
countermand: contra-ordem
countless: incontável
country: campo, país
countryman: compatriota
countryside: campo
county: condado
coupé: compartimento
couple: pares
courage: coragem
course: curso, prato
court: pátio, corte
courtyard: pátio
cousin: primo, prima
cover: tampa, capa
cow: vaca
cowardice: covardia
cowboy: vaqueiro
cowl: capuz
coyote: chacal
crab: caranguejo
crack: rachadura
cracked: rachado
cradle: berço
cramp-iron: grampe-ferro
crane: guindaste
crawl: rastejamento
crayfish: caranguejo, lagostas
craze: mania
crazy: louco
cream: creme, nata
crease: vinco
create: críe
creature: criatura
credential: credencial
credit: crédito
creep: rastejamento
cremation: cremação
crevice: fenda
crew: grupo, equipagem, tripulação
cricket: grilo
Crimea: Criméia
crippled: aleijado
crisis: crise
critical: crítico
criticize: critique
crocodile: crocodilo
crocus: açafrão
crook: trafulha
cross: cruz
crosswise: transversalmente
crow: corvo
crow-bar: alavanca
crowbar: alavanca
crowd: multidão
crown: coroa
crucifix: crucifixo
crude: cru
cruise: cruzeiro
crumb: migalha
crush: esmagamento
cruzeiro: cruzeiro
cry: grito, chorar
crystal: cristal
Cuba: Cuba
Cuban: Cubano
cube: cubo
cuckoo: cuco
cucumber: pepino
cul-de-sac: beco sem saída
culprit: culpado
cultivate: cultive
culture: cultura
cultured: cultivado
cup: chávena, xícara, copo
cupboard: armário
cupola: cúpula
cure: cura
curiosity: curiosidade
curious: curioso
curl: onda
currant: passa de Corinto
currant-bush: passa de Corinto-arbusto
currant-jam: passa de Corinto-atole
currant-leaf: passa de Corinto-folha
currency: moeda corrente
current: corrente, atual
currently: atualmente
curry: caril
curtain: cortina
curve: curva
curved: curvado
cushion: coxim
custom: costume
custom-house: alfândega
customary: habitual
customer: cliente, freguês
customs: costumes
cut: corte
cutlet: costoleta, costeleta
cybernetics: cibernética
cycle: ciclo, bicicleta
cycle-bag: ciclo-saco
cylinder: cilindro
cynical: cínico
cypres: cipreste
Cyprus: Chipre
Czechoslovakia : Checoslovaquia, Checoslováquia
daily: diáriamente, diário
dainty: guloseima
dairy: leitaria, leiteria
Dakar: Dacar
dam: represa
damage: os danos
damaged: danificado
Damascus: Damasco
damn: nada
damp: umidade
dampen: umedeça
dance: dança
Dane: Dinamarquês
danger: perigo
dangerous: perigoso
Danish: Dinamarquês
Danube: Danúbio
dare: desafio
daring: audaz
dark: escuro
darken: escureça
darkness: escuridão
darling: querido
data: dados
date: tâmara, data
date-palm: tamareira [palmeira que dá tâmara]
daughter: filha
dawn: alvorecer
day: dia
day-dreamer: dia-day-dreamer
day-ticket: dia-bilhete
daybreak: aurora
daylight: luz do dia
deacon: diácono
dead: inoperante
deadly: mortal
deaf: surdo
deal: negócio, acordo
dean: decano
dear: caro
death: morte
debatable: discutível
debit: débito
debris: restos
debt: débito
decade: década
decay: deterioração
decayed: deteriorado
deceive: iluda
December: Dezembro
decide: decida
decipher: decifração
decision: decisão
deck: coberta, plataforma
declaration: declaração
decline: declínio
decoction: decocção
decode: decodifique
decorate: decore
decoration: decoração
decrease: diminuição
dedicate: dedique
deduce: deduza
deduct: deduza
deem: julgue, acreditar, crer
deep: profundamente
deer: cervos
defeat: derrota
defence: defesa
defend: defenda
defendant: réu
defense: defesa
define: defina
definite: definitivo
definitely: definitivamente
definition: definição
deformed: deformado
defraud: defraude
degree: grau
delay: atraso
delegate: delegado
delete: supressão
Delhi: Deli
deliberately: deliberadamente
delicate: delicado
delicious: delicioso
delight: prazer
delighted: deleitado
delightful: delicioso
deliver: entregue
delivery: entrega
demand: demanda
democracy: democracia
democrat: democrata
democratic: democrático
demonstrate: demonstre
demonstration: demonstração
demonstrative: demonstrativo
den: ninho
Denmark: Dinamarca
dense: denso
dentist: dentista
deny: negue
depart: parta, afastar-se
department: departamento
departure: partida
depend: dependa
dependence: dependência
dependent: dependente
depict: descreva
deportment: conduta, comportamento
deposit: depósito
depress: comprima
depth: profundidade
depute: delegue
deputy: deputado
derivation: derivação
descend: descer, desça
descent: descida
describe: descreva
description: descrição
desert: deserto
deserve: mereça
deserving: digno, merecer
design: projeto
desire: anseio, querer, desejar, desejo
desk: escritório, mesa
desolate: desolado
despair: desespero
desperate: desesperado
despite: despeito
destroy: destrua
destruction: destruição
detachable: destacável
detached: destacado
detachment: destacamento
detail: detalhe
detailed: detalhado
detain: detenha
detective: detetive
detergent: detergente
deterrent: impedimento
detrimentally: prejudicial
develop: torne
development: desenvolvimento
device: aparelho, dispositivo
devil: diabo
devoted: devotado
dew: orvalho
diagram: diagrama
dial: seletor
dialog: diálogo
dialogue: diálogo
diameter: diâmetro
diamond: diamante
diary: diário
dice: dados
dictate: ordem
dictator: ditador
dictionary: dicionário
die: dado, morrer
diet: dieta
dietary: dietético
differ: difira
difference: diferença
different: diferente
differentiate: diferencie
differently: diferentemente
difficult: difícil
difficulty: dificuldade
dig: escavação
digest: sumário
digestion: digestão
digit: dígito
dignity: dignidade
dilapidated: dilapidado
diligent: aplicado
dilute: diluído
dim: não ofuscante
dimension: dimensão
diminish: diminua
diminutive: pequeno, diminutivo
din: ruído
dinner: jantar, almoço
dip: mergulho
diplomat: diplomata
direct: direto
direction: direção, sentido, direcção
directions: sentidos
directly: diretamente
director: diretor, director
directory: diretório
dirty: sujo
disadvantage: desvantagem
disadvantageous: desvantajoso
disappear: desapareça
disappoint: decepcione
disappointment: desapontamento
disapproval: desaprovação
disarm: desarme
disc: disco
discard: descarte
discharge: descarga
discipline: disciplina
discount: desconto
discourage: desanime
discover: descubra
discovery: descoberta, descobrimento
discrete: discreto
discrimination: discriminação
discuss: discuta
discussion: discussão
disease: doença
disgust: aversão
disgusting: repugnar
dish: prato
disk: disco
dislike: desagrado
dislocate: desloque
dismay: desânimo
dismiss: demita
dismount: desmonte
dispatch: expedição
disperse: dispersão
display: exposição
disposal: eliminação
disposition: disposição
dispute: disputa
dissipation: dissipação
dissolve: dissolva
distance: distância
distant: distante
distinct: claro, distinto
distinction: distinção
distinctive: distintivo
distinguish: distinga
distribute: distribua
distribution: distribuição
distributor: distribuidor
district: distrito
disturb: perturbe
disturbance: distúrbio
ditch: vala
divan: divã
dive: mergulho
diver: mergulhador
diverse: diverso
diversion: diversão
divert: desvíe
divide: dividir, divida
diving-bell: diving-sino
division: divisão
divorce: divórcio
divorced: divorciado
do: fazer
dock: doca
doctor: médico, doutor
document: documento, original
dog: cão
doll: boneca
dollar: dólar
dome: abóbada
domestic: doméstico
dominate: domine
donate: doe
done: feito
donkey: asno, burro
door: porta
doorway: entrada
dot: ponto
double: dobro
doubt: dúvida, duvidar
doubtful: duvidoso
dough: massa de pão
dove: pombo, pomba
down: para baixo
downstairs: abaixo
dozen: dúzia
draft: esboço
drag: puxar, arrasto
dragonfly: libélula
drain: dreno
drama: drama
drape: drapeje
drastic: drástico
draw: puxar, tração
drawer: gaveta
drawers: ceroulas, gavetas
drawing: desenho
drawing-paper: extra-papel
dreadful: terrível
dream: sonho
dress: vestido
dress-coat: vist-revestimento
dresser: aparelhador
drift: tração
drill: brocas
drink: beber, bebida
drip: gotejamento
drive: movimentação
driver: excitador
driving-licence: licença de motorista
droop: inclinação
drop: gota, cair
droplet: gota
drown: afogue-se
drug: droga
drugstore: drograria
drum: cilindro
drunk: bêbedo
dry: seco
dual: duplo
duck: pato
dude: gajo
dues: dívidas
duke: duque
dull: maçante
dunning-letter: dunning-letra
duplicate: duplicata
during: durante
dust: pó, poeira
dusty: empoeirado
Dutch: Holandês
Dutchman: Holandês
duty: dever
dwarf: anão
dwell: morar, interrupção
dwelling: aposento, moradia
dwelling-place: moradia-lugar
dye: cor, tintura
dynamite: dinamite
E-chord: E-corda
each: cada um, todo
eagle: águia
ear: orelha, ouvido
early: cedo
earn: ganhe, ganhar
earnest: sério
earth: terra
earthquake: terremoto
earthworm: minhoca
easel: armação
easily: fàcilmente
East: leste
east: leste
East: Do leste
eastern: oriental
easy: fácil
eat: coma
ecclesiastic: eclesiástico
echo: eco
economical: econômico
economics: economia
economy: economia
Ecuador: Equador
edge: borda, margem
Edinburgh: Edimburgo
edit: edite
edition: edição
educate: eduque
educated: educado
education: instrução
eel: enguia
eel-skin: enguia-pele
eel-trap: enguia-prenda
effect: efeito
effective: eficaz
effort: esforço
egg: ovo
Egypt: Egipto
eight: oito
eighteen: dezóito, dezoito
eighteenth: décimo oitavo
eighth: oitavo
elastic: elástico
elbow: cotovelo
elder: pessoa idosa
elderly: idoso
elect: escolher, eleja
elected: eleito
election: eleição
electric: elétrico, eléctrico
electricity: electricidade, eletricidade
electron: elétron
electronic: eletrônico
electronics: eletrônica
elegant: elegante, esbelto
element: elemento
elementary: elementar
elephant: elefante
elevator: elevador, ascensor
eleven: onze
eliminate: elimine
elk: alces
elm: olmo
else: mais, outro
elsewhere: em outra parte
elver: enguia jovem
embassy: embaixada
emblem: emblema
embrace: abranger
embroider: borde
emerge: emerja, aparecer
emergency: emergência
eminent: eminente
emit: emita-se
emotion: emoção
emphasis: ênfase
emphasize: emfatize, sublinhar
empire: império
employ: empregar, empregue, usar
employee: empregado
employer: empregador
employment: emprego
empty: vácuo, vazio
enamel: esmalte
enclose: inclua
enclosure: cerco
encode: codifique
encounter: encontro
encourage: incentive
encouragement: incentivo
encyclopedia: enciclopédia
end: extremidade, fim
end-of-the-line: extremidade da linha, fim da linha
endanger: ponha em perigo
endeavour: esforço
ending: fim
endlessly: infinita
endorse: endosse
endorsee: endossado
endorsement: endosso
endorser: endossante
endow: dote
endure: padecer, resista
enemy: inimigo
energetic: energético
energy: energia
engaged: acoplado
engine: motor, locomotiva
engineer: engenheiro, coordenador
England: Inglaterra
English: Inglês
Englishman: Inglês
engrave: grave
enhance: realce
enjoy: aprecíe
enjoyable: agradável
enlarge: amplíe
enlargement: ampliação
enlist: aliste
enormous: enorme
enormously: enormemente
enough: bastantes, bastante
enter: entre
enterprise: empresa
enterprising: empreendedor
enthusiasm: entusiasmo
enthusiastic: entusiástico
entice: seduza
enticing: seduzir
entire: inteiro
entirely: completamente, inteiramente
entirety: totalidade
entrance: entrada
entry: entrada
envelope: envelope
environment: ambiente
equal: igual
equality: igualdade
equally: igualmente
equator: Equador
equilibrium: equilíbrio
equinox: equinócio
equip: equipe
equipment: equipamento
equivalent: equivalente
erase: apague
eraser: eliminador
erect: ereto
erecting: erigir
erroneous: errôneo
error: defeito, erro
escort: escolta
escudo: escudo
Eskimo: Esquimó
especially: principalmente, especial, sobretudo
essence: essência
essential: essencial
establish: estabeleça
establishment: estabelecimento
estate: fazenda, granja, propriedade
esteem: respeito
estimate: avaliar, estimativa, orçar
Estonia: Estônia
etc.: etc.
etching: gravura a água-forte
ethic: ética
ethical: ético
Ethiopia: Etiópia, Etiopia
Europe: Europa
European: Europeu
evacuate: evacue
evade: evitar
evaporate: evapore
even: mesmo, nivele, até
evening: noite
evening meal: ceia
event: evento
ever: sempre
every: todo, cada
everyday: diário
everyone: todo, todos
everyone's: todos
everything: tudo
everywhere: em toda parte
evident: evidente
evolution: evolução
evolve: evolua
exact: exato, exacto
exactly: exatamente, justamente
examination: exame, examinação
example: exemplo
exceed: exceda
excellency: excelência
except: exceto
exception: exceção
exceptional: excepcional
excessive: excessivo
excessively: excessivamente
exchange: troca
excise-duty: excise-dever
excitation: excitação
excitement: excitamento
exciting: excitar
exclude: excluir, exclua
exclusive: exclusivo
exclusively: exclusivamente, só, somente
excursion: excursão
excuse: desculpa
excuse me: desculpe, perdoe-me
execute: executar
exercise: exercício
exert: exerça
exhausted: esgotado
exhibit: exibição
exist: exista, existir
existence: existência
exit: saída
expansion: expansão
expect: espere, esperar
expedite: expida
expedition: expedição
expel: expila
expense: despesa
expenses: despesas
expensive: caro
experience: experiência
experienced: experiente
experiment: experiência
expert: perito
expire: morrer
explain: explique, explicar
explanation: explicação, explanação
explode: expluda
exploit: façanha
exploration: exploração
explosion: explosão
export: exportação
expose: exposição
exposition: exposição
express: expressar, expresso
expression: expressão
extend: estenda
extension: extensão
extensive: extensivo
exterminate: elimine
external: externo
extinguish: extinga
extract: extrato
extraordinarily: extraordinàriamente
extraordinary: extraordinário
extreme: extremo
extremely: extremamente
eye: olho
eyebrow: sobrancelha
eyelid : pálpebra
fabric: tela, tecido
fabricate: fabrique
face: cara
face-ache: cara-face-ache
facile: fácil
facilitate: facilite
fact: fato
factory: fábrica
faculty: faculdade
fade: desvaneça-se
fail: falha
failure: falha
faint: fraco, débil
fair: justo
fairly: razoavelmente
faith: fé
faithful: fiel, confiável
fall: queda, cair
false: falso
fame: fama, glória
family: família
famous: famoso
fan: ventilador
fancier: mais extravagante
fancy: fantasia
fantastic: fantástico
far: distante
Far East: Extremo-Oriente
farewell: adeus
farm: granja, fazenda
farmer: fazendeiro
farmland: terra
fascinate: fascine
fascinated: fascinado
fascinating: fascinar
fashion: moda, forma
fast: rápido, depressa
fast train: expresso
fasten: prenda
fat: gordo, gordura
father: pai
fatigue: fadiga
fault: falha
favorite: favorito
favour: favor
favourable: favorável
favourite: favorito
fear: receio, recear, medo, temer
feast: festa
feather: pena
feature: característica
February: Fevereiro
feed: alimentação
feel: sensação
feeling: sentimento
feign: finja
fellow: companheiro, homem
fellow-creature: companheiro-criatura
fellow-thinker: companheiro-fellow-thinker
felt: feltro
female: fêmea
female cook: cozinheira
female hairdresser: cabeleireira
female journalist: jornalista
female relative: parente
female singer: cantora
female stenotypist: datilógrafa, dactilógrafa
female tailor: costureira
female teacher: mestra
fence: cerca
ferry: balsa
fertile: fértil
fertilizer: fertilizante
fervor: zelo
fervour: zelo
fetch: busque
fever: febre
few: poucos
fiancé: noivo
fiancée: noiva
fiber: fibra
fibre: fibra
field: campo, prado
fierce: feroz
fifteen: quinze
fifth: quinto
fifty: cinqüenta
fig: figo
fig-tree: fig-árvore, figueira
fight: luta, pelejar
figurative: figurativo
figure: figura
file: fila, lima, arquivo
files: limas, arquivos
fill: encher, suficiência
fill in: encher
fill up: encher
film: película
filter: filtro
filthy: sujo
fin: aleta, barbatana
final: final
finally: finalmente
finance: finanças
financial: financeiro
find: achado
fine: belo, excelente, formoso, multa, muito bem
finger: dedo
finish: revestimento
finished: terminado, pronto
Finland: Finlândia
Finn: finlandês
fir: abeto
fire: fogo
fire-alarm: fogo-alarme
firing-cap: acendimento-tampão
firm: firma
firmly: firmemente
first: primeiramente, primeiro
first-aid: de primeiros socorros
first-aider: primeiro-ajudante
first name: nome, primeiro nome
fish: peixe
fisherman: pescador
fishing rod: cana
fist: punho
fit: ajuste
fitness: aptidão
fitting: caber
five: cinco
fix: reparo
fix up: arranjar
fixed: fixo
flag: bandeira
flame: flama, chama
flammable: inflamável
Flanders: Flandres
flare: alargamento
flat: liso
flatter: alisador
flavor: sabor
flavour: sabor
flea: pulga
flee: fuja
fleet: frota
flesh: carne
flexible: flexível
flicker: cintilação
flier: inseto
flight: vôo
fling: arremesse
float: flutuar, flutuador, nadar
flock: rebanho
flood: inundação
floor: andar, soalho, assoalho
Florence: Florença
flounder: solha
flour: farinha
flourish: floresça
flow: fluxo, corrente
flower: flor
flu: gripe
fluid: líquido
Flushing: Nivelar
flute: flauta
flutter: vibração
fly: voar, mosca
foam: espuma
focus: foco
fog: neblina, névoa
fold: dobra
folder: dobrador
folk: povo, povos
follow: seguir, siga
follow-up: continuação, acompanhamento
followers: seguidores
following: seguinte
food: alimento, comida
fool: tolo
foot: pé
footwear: calçado
for: durante, para
for the reason that: porque
forbid: proibir
forbidding: proibido
force: força
forecast: previsão
foreground: primeiro plano
forehead: testa, fronte
foreign: estrangeiro
foreigner: estrangeiro
foresee: preveja
forest: floresta
forever: para sempre
foreward: adiante
foreword: prefácio
forfeit: perda
forge: forja
forged: forjado
forget: esqueça-se, esquecer-se
forgive: perdoe
fork: forquilha, garfo
form: formulário
former: anterior, ex-
formerly: diante, anteriormente, antes
formula: fórmula
formulate: formule
fortunate: feliz, afortunado
fortunately: felizmente
fortune: fortuna
forty: quarenta
forward: para diante
foul: sujo
found: encontrado
foundation: fundo, fundação
fountain: fonte, nascente
four: quatro
fourteen: quatorze, catorze
fourth: quinto, quarto
fowl: galinha
fox: raposa
fraction: fração
fracture: fratura
fragile: frágil
fragment: fragmento
fragrant: perfumado
frame: quadro
framework: estrutura
France: França
Frankfurt: Francoforte
free: livre
freedom: liberdade
freezing cold: geada
French: Francês
Frenchman: Francês
frequent: freqüente
frequently: freqüentemente
fresh: fresco
friction: fricção
Friday: Sexta-feira
friend: amiga, amigo
friendly: amigável
friendship: amizade
frog: rã, râ
from: de
front: parte dianteira
frontier: fronteira
frost: geada
frosted: geado
froth: espuma
frozen: congelado
fruit: fruta
frustrate: frustre
fry: frite
frying-pan: frigideira
fuck: foda
fuel: combustível
full: completamente, cheio
fully: inteiramente
fume: emanações
fun: divertimento
function: funcionar, função
fund: fundo
fungus: fungo
funnel: funil
funny: engraçado
fur : pele
furnace: fornalha
furnish: forneça
furnished: fornecido
furniture: movéis
further: mais adicional
furthermore: além disso
fuse: fusível
future : futuro
gad-fly: gad-voe
gag: mordaça
gain: ganho, ganhar
Galicia: Galiza
gall: bílis
gallery: galeria
game: jogo
gang: grupo
gaol: prisno, cadeio, cadeia
gap: abertura
garage: garagem
garden: jardim
gardener: jardineiro
gardening: jardinar
garlic: alho
gas: gás
gasolene: gasolina
gasoline: gasolina
gate: porta
gateway: passagem
gather: recolhimento, colher
gathering: recolhimento
gaunt: delgado
gaze: olhar
gazette: jornal, gazeta
gear: engrenagem
gear-box: caixa de engrenagens
general: geral
generally: geralmente
generate: gere
generation: geração
generous: generoso
Geneva: Genebra
genius: gênio
gentle: suave, delicado, gentil
gentleman: cavalheiro
gently: delicadamente, gentilmente
genuine: genuíno
genuinely: genuinamente
genuinly: deveras, verdadeiramente
geographic: geográfico
geographical: geográfico
geography: geografia
geologist: geólogo
geology: geologia
geometry: geometria
Georgia: Geórgia
germ: germe
German: Alemão
Germany: Alemanha
gesture: gesto
get: receber, obter, comece, adquirir
get-at-able: começa-capaz
get angry: zangar-se
get married: casar-se
giant: gigante
gift: presente, dádiva
gigantic: gigantesco
gill: brânquia
girl: garota, menina, moça, rapariga
give: elasticidade, dê
give rise to: causar
glacier: geleira
glad: contente
gladness: alegria,contentamento
glass: vidro, copo
glasses: vidros, óculos
glaze: esmalte
glide: deslize
glider: planador
globe: globo
globe-trotter: globo-trotador
glorify: glorifique
glory: glória
gloss: lustro
glossary: glossário
glove: luva
glow: fulgor
glue: colagem, solfar
gnat: mosquito
gnat-bite: mosquito-mordida
gnaw: roer
go: ir, vá
go away: afastar-se
go down: descer
goal: alvo, objetivo, gol
goat: cabra
god: deus
gold: ouro
gold-coloured: ouro-colorido
golden: dourado
good: bom
good-looking: bem parecido
good-smelling: bom-good-smelling, cheirando bem
goodbye: adeus
goods: bens
goose: ganso
gooseberry: groselha
gossip: bisbolhetice, fofoca
gourd: abóbora
govern: governe, reger
government: governo
gown: vestido
grab: garra, agarrar
graceful: gracioso
grade: classe
gradually: gradualmente
graduate: graduado
grain: grão
gram: grama
grammar: gramática
gramme: grama
grammophone disc: disco
grand: grande
grand-nephew: grande-grand-nephew
grandfather: avô
grandmother: avó
grandson: neto
granite: granito
grape: uva
grapevine: videira
graphic: gráfico
graphics: gráficos, imagens
grasp: aperto
grass: erva, grama
grasshopper: gafanhoto
gratis: gratuitamente
gratitude: gratidão, agradecimento
grave: sepultura
gravel: cascalho
graveyard: cemitério
gravity: gravidade
gravy: molho
gray: cinzento
graze: paste
grease: graxa, gordura
greasy: gorduroso
great: grande, excelente
great-grandfather: grande-avô, bisavô
great-grandmother: grande-avó, bisavó
great-grandparent: grande-grandparent
Great Britain: Grã-Bretanha
Greece: Grécia
Greek: Grego
green: verde
Greenland: Gronelândia
greet: cumprimente
greeting: cumprimento
grey: cinzento
grid: grade
grieve: aflija-se
grill: grade
grip: gripe, aperto
gripped: prendido
grit: grão
groan: gemido
ground: fundo, terra
ground-floor: térreo, rés-do-chão
grounding: aterrar
grounds: terras
group: grupo
grow: cresça, acontecer, crescer
growl: rosnado
growth: crescimento
guarantee: garantia
guard: protetor, condutor
guelder-rose: guelder-levantou-se
guess: Suposição
guest: convidado, hóspede
guide: guia
guilt: culpa
guilty: culpado
guinea-pig: cobaia
guitar: guitarra
gulf: golfo
gum: gengiva
gun: injetor, espingarda
gun-carriage: injetor-carruagem
gurgle: gorgolejo
Gypsy : Cigano
H-bomb: bomba-H
habit: hábito
hack: corte
hail: granizo, saraiva
hair: pêlo, cabelo
hair-do: cabelo-
hair-splitter: cabelo-divisor
hair-splitting: cabelo-hair-splitting
hairdresser: cabeleireira, cabeleireiro
hairs: cabelos
half: meio
half-tone: reticulação, meio tom
hall: salão
halt: parar, parada
halyard: adriça
ham: presunto
Hamburg: Hamburg, Hamburgo
hammer: martelo
hammering: martelar
hand: mão, obreiro
handbook: manual
handful: punhado
handkerchief: lenço
handle: punho
handlebars: leme
handsome: belo, considerável, formoso
handy: acessível
hang: cair
hang-glider: pendur-planador
happen: aconteça, acontecer
happiness: felicidade
happy: feliz
harbor: porto
harbour: porto
hard: difícil, duramente
hard-worked: duro-trabalhado
harden: endureça
hardly: mal, apenas
hardness: dureza
hardworking: aplicado
hare: lebre
haricot: feijão
harm: dano
harmful: prejudicial
harmonica: harmônica
harmony: harmonia
harness: chicote de fios
harsh: áspero
harvest: : colheita
haste: pressa
hastily: precipitadamente
hat: chapéu
hate: ódio
haul: puxar, transporte
have: haver, receber, tenha
have a bath: banhar-se
have got: haver
Hawaii: Havaí
Hawaiian: Havaiano
hawk: falcão
hay: feno
hazard: perigo, risco
hazardous: perigoso
haze: embaçamento
hazelnut: avelã
he: ele
head: cabeça
header: encabeçamento
heading: título
headlamp: farol
headlight: farol
headquarters: matrizes
health: saúde
healthy: saudável
hear: ouça, ouvir
heart: coração
heat: calor
heater: calefator, aquecedor
heaven: céu
heavy: pesado
heel: talão, salto
height: altura, altitude
helix: hélice
hell: inferno
helm: leme
helmet: capacete
help: ajuda, auxílio, ajudar
helper: ajudante
helpful: útil
Helsinki: Helsínquia
hemisphere: hemisfério
hen: galinha, frango
hence: daqui
her: ela
herd: rebanho
here: aqui, cá
hero: herói
herring: arenque
hers: dela
herself: ela mesma
hesitation: hesitação
hidden: escondido
high: elevado, alto
high-handedness: elevado-high-handedness
high tide: preamar
highway: auto-estrada
hill: monte, colina
him: ele
himself: ele mesmo
hindmost: mais hindmost
hinge: dobradiça
hinny: mula
hint: sugestão
hip: quadril
hiss: silvo
history: história
hit: bater, batida
hither: cá
hobby: passatempo
hoe: enxada
hold: porão
holder: suporte
hole: furo
holiday: sueto, feriado, féria
Holland: Holanda
Hollander: Holandês
hollow: cavidade
honest: honesto
honey: mel
honor: honra
honour: honra
hood: capa
hoof: casco
hook: gancho, anzol
hooter: buzina
hope: esperança
hopefully: esperançosamente
horizon: horizonte
horn: chifre
horse: cavalo
horse-fly: cavalo-voe
horsepower: cavalos-força
horseshoe: ferradura
hospital: hospital
host: anfitrião
hostage: refém
hostile: hostil
hot: cálido, quente
hotel: hotel
hour: hora
house: casa
house: casa
housefly: mosca
hover: pairo
how: como, quão
how?: como?
however: embora, contudo, entretanto
hub: cubo
hub-cap: cubo-tampão
hug: abranger
huge: enorme
human: humano
humane: humano
humanist: humanista
humid: úmido
hundred: cem
Hungarian: húngaro
Hungary: Hungria
hunger: fome
hungry: com fome
hunt: caça
hunter: caçador
hurricane: furacão
hurried: apressado
hurriedly: precipitadamente
hurry: pressa
husband: marido, esposo
hut: cabana
hygiene: higiene
hygienic: higiênico
hypothesis: hipótese
hypothetical: hipotético
ice: gelo
Iceland: Islândia
icing: crosta de gelo
icon: ícone
icy: gelado
idea: idéia
identical: idêntico
identify: identifique
identity: identidade
idiotic: idiota
if: se, si
ignition: ignição
ill: doente
illness: doença
illuminate: ilumine
illustrate: ilustre
illustration: ilustração
image: quadro, imagem
imagination: imaginação
immaterial: imaterial
immediate: imediato
immediately: imediatamente, directamente
immune: imune
impartial: imparcial
impetus: ímpeto
implicate: implique
imply: implique
import: importação
important: importante, categorizado
impose: imponha
imposing: imponente
impossible: impossível
impossibly: impossivel
impress: imprima
impression: impressão
improve: melhore
impulse: impulso
in: em
in-: em
in a hurry: precipitadamente
in addition: demais
in exchange for: contra
in order to: para
in vain: debalde
inch: polegada
inclination: inclinação
include: conter, inclua
including: incluir
inclusive: inclusivo
inclusively: inclusiva
income: renda
incomplete: incompleto
inconvenient: difícil, inconveniente
incorrect: incorreto
increase: aumento
increasingly: cada vez mais
indeed: certamente, verdadeiramente, deveras
indent: recorte
index: índice
India: India
Indian corn: milho
indicate: indique, mostrar
indication: indicação
indicative: indicativo
indifferent: indiferente
Indonesia: Indonésia
induce: induza
industrialist: industrialista
industrious: aplicado
industry: indústria
inert: inerte
inexpensive: barato
infant: criança, menino, infante, menina
infantry: infantaria
infection: infecção
infirm: fraco
inflate: infle
inflated: inflado
inflation: inflação
influence: influência
influenza: gripe
inform: informe
information: informação
inhabitant: habitante
inherit: herde
inhibit: iniba
inhuman: inumano
initial: inicial
initiate: novato
inject: injete
injection: injeção
injure: fira
injured: ferido
injury: ferida, ferimento
ink: tinta
inlet: entrada
inner: interno
innocent: inocente
inoculate: inocule
input: entrada
inquiry: inquérito
inquiry-office: inquérito-escritório
insane: insano
insect: inseto, insecto
insert: inserção
inside: para dentro, em
insignificant: insignificante
insinuate: insinue
insist: insistir, insista
inspect: inspecione
inspection: inspeção
inspiration: inspiração
inspiring: inspirar
install: instale
instalment: prestação
instant: imediato
instantly: directamente, imediatamente
instinct: instinto
institute: instituto
institution: instituição
instruct: instrua
instruction: instrução
instructor: instrutor, mestre
instrument: instrumento
insulate: isole
insulation: isolação
insulator: isolador
insult: insulto
insurance: seguro
insure: segure
integer: inteiro
intellectual: intelectual
intelligence: inteligência
intelligent: inteligente
intend: tencionar, pretenda
intense: intenso
intention: intenção
intentional: intencional
intercede: interceda
interchange: intercâmbio
interest: interesse
interested: interessado
interesting: interessar
interface: relação
interference: interferência
intermittent: intermitente
internal: interno
international: internacional
interpret: intérprete
interpretation: interpretação
interpreter: intérprete
interrupt: interrupção
interval: intervalo
intervene: intervenha
interview: entrevista
into: em
introduce: apresentar, introduza
introduction: introdução
invade: invada
invasion: invasão
invent: invente
invention: invenção
inventory: inventário
investigate: investigue
investigation: investigação, exame
invitation: convite
invite: convidar, convide
invoice: factura, fatura
invoke: invoque
inwards: para dentro
iodine: iodo
Iran: Irã
Ireland: Irlanda
Iris: Íris
Irishman: irlandês
iron: férreo, ferro
island: console, ilha
isolated: isolado
isolation: isolação
Israel: Israel
issue: edição
Istanbul: Istambul
it: ele
Italian: Italiano
Italy: Itália
item: artigo
its: seu
itself: próprio
ivory : marfim
jack: jaque, macaco
jacket: revestimento, jaqueta
jail: cadeia, prisão, cadeia
jam: compota, atolamento
Jamaica: Jamaica
January: Janeiro
Japan: Japão
Japanese: Japonês
jargon: jargão
jaw: queixada, maxila
jawbone: maxila, queixada
jaws: maxilas
jerk: empurrão
jewel: jóia
jeweller: joalheiro
job: tarefa, trabalho
job-: trabalho
jog: movimento
Johannesburg: Joanesburgo
join: junte, ligar
joining: juntar
joint: junção
joke: gracejo
jolt: sacudida
Jordan: Jordão
journal: jornal
journalist: jornalista
journey: viagem
joy: alegria
joystick: manche
judge: juiz
judgment: julgamento
jug: jarro
juice: suco
July: Julho
jump: salto
junction: junção
June: Junho
jungle: selva
junior: júnior
jury: júri
just: somente, só, apenas
justice : justiça
kangaroo: canguru
keel: quilha
keen: afiado
keep: poupar, observar, sustento
kernel: semente
kerosene: querosene
kettle: chaleira
key: chave
keyboard: teclado
kick: pontapé
kid: miúdo, menino, cabrito
kidney: rim
kill: matança, matar
kilometer: quilômetro
kilometre: quilômetro
kind: amável, espécie, género
kindle: acender
kindness: bondade
king: rei
kingdom: reino
kirk: igreja
kiss: beijar, beijo
kitchen: cozinha
kitten: gatinho
knee: joelho
kneel: genuflexão
knife: faca
knob: botão
knock: batidas
knot: nó
know: saber, saiba
know how: saber
knowledge: conhecimento
Korea : Coréia
label: etiqueta
laboratory: laboratório
laborer: obreiro
labour: trabalho
labour-union: trabalho-união, sindicato
labourer: obreiro, trabalhador
lace: laço
lack: falta
lacquer: laca
ladder: escada
lady: senhora
lagoon: lagoa
lake: lago
lamb: cordeiro
lamp: lâmpada
land: terra, país
landing: aterragem
landing-stage: aterragem-estágio
landmark: marco
landscape: paisagem
lane: beco, pista
language: língua, linguagem
lantern: lanterna
lap: regaço
lapse: lapso
lapsed: decorrido
larder: aparador
large: grande
lark: cotovia
lass: garota, moça, rapariga
last: último
lasting: durar
late: tarde
lately: ultimamente
later: mais tarde
lathe: torno
laugh: riso, rir
laughter: riso
launch: lançamento
laundry: lavanderia
laurel: loureiro
law: lei
lawn: gramado
lawyer: advogado
lay: configuração
lay-by: colocar-por
lay down: por, meter, colocar
layer: camada
lazy: preguiçoso
lead: ligação, chumbo
leader: líder
leading: conduzir
leaf: folha
league: liga
lean: delgado
leap: pulo
leap-year: pulo-ano
learn: aprenda, aprender
learned: instruído
learnt: aprendido
lease: aluguel
least: menos
leather: couro
leave: licença, afastar-se
leaving-certificate: leaving-certificado
Lebanon: Líbano
lectern: atril
left: esquerdo
leg: pé, perna
legend: legenda
legendary: legendário
lemon: limão
lemonade: limonada
lend: emprestar, empreste
length: comprimento
lengthen: alongue
lengthwise: longitudinalmente
lens: lente
lentil: lentilha
leopard: leopardo
less: menos
lessen: diminua
lesson: lição
let: deixado
letter: carta, letra
lettuce: alface
level: nível
level-crossing: nível-cruzamento
lever: alavanca
library: biblioteca
Libya: Líbia
licence: licença
lid: tampa
lie: mentira
lieutenant: tenente
life: vida
lift: ascensor, elevador
light: débil, luz, fraco, acender
light-switch: comutador, luz-interruptor
lighter: mais claro
lighthouse: farol
lightly: levemente
lightning: relâmpago
like: quão, como
like this: tão, tais, tal, assim
likely: provavelmente
lily: lírio
limb: membro
lime: cal
lime-tree: tília, cal-árvore
limit: limite
limited: limitado
linden-tree: linden-árvore, tília
line: fio, fila, linha
linen: linho
lineseed-oil: lineseed-óleo
linguist: lingüista
linguistic: lingüístico
lining: forro
link: ligação
lion: leão
lip: bordo, lábio
liquid: líquido
liquidate: matar
liquor: licor
Lisbon: Lisboa
lisp: cicie
list: lista
listen: escutar, escute
listener: ouvinte
liter: litro
literary: literário
literature: literatura
litigate: litigue
litre: litro
little: pequeno, pouco
live: vivo, morar, viver
lively: vívido
liver: fígado
livestock: animais domésticos
living room: sala
load: carga
loaf: pão
loan: empréstimo
loathe: deteste
lobster: lagosta
locate: localize
location: posição
lock: fechamento, fechadura
locomotive: locomotiva
locust: gafanhoto, locustídeo
lofty: alto, elevado
logic: lógica
logical: lógico
London: Londres
lonely: só
long: comprido, por muito tempo
look: olhar, olhadela
loom: tear
loop: laço
loose: frouxo
loosely: frouxamente
lord: senhor
Lorraine: Lorena
lose: perca, perder
loss: perda
lost: perdido
lot: lote
loud: ruidosamente
loudly: alta
louse: piolho
love: amor
lovely: formoso, belo, caro, encantador
lover: amante
low: baixo
low tide: baixamar
lower: mais baixo
loyal: leal
luck: sorte
luggage: bagagem
luggage-van: furgão, bagagem-camionete
lukewarm: morno
lump: protuberância
lung: pulmão
luxury : luxo
macaroni: macarrão
Macedonian: Macedônio
machine: máquina
machinery: maquinaria
mackerel: cavala
mad: louco
magazine: jornal, compartimento
magic: mágica
magical: mágico
magician: mágico
magnet: ímã
magnetic: magnético
magnetism: magnetismo
magnificent: magnífico
maid: empregada doméstica, criada
mail: correio
mailbox: caixa postal
main: principal
mainly: principalmente
maintain: mantenha
maize: milho
majestic: majestoso
major: principal
majority: maioria
make: fazer, faça
make-up: composição
make clean: limpar
make use of: usar, empregar
making: fazer
malaria: malária
male: macho
malfunction: mau funcionamento
Malian: Maliense
malicious: malicioso
malign: calunie
mammal: mamífero
man: homem
manage: controle
management: gerência
manager: gerente, diretor
mandate: mandato
maneuver: manobra
mango-tree: mango-árvore, mangueira
manifest: manifesto
manipulate: manipule
mankind: humanidade
manner: maneira, modo
manœuvre: manobra
manoeuvre: manobra
mantel: cornija de lareira
manufacture: manufatura
manuscript: manuscrito
many: muitos
map: mapa
maple: bordo
marble: mármore
March: Março
margin: margem
mark: marca, aceno
market: mercado
marketplace: mercado
marmelade: compota
marriage: união, matrimônio
married: casado
marry: casar-se, case
Mars: Marte
marsh: pântano
marvel: maravilha
mask: máscara
mass: massa
massive: maciço
mast: mastro
master: amo, mestre
mat: esteira
match: fósforo
match-make: fósforo-faça
match-maker: fósforo-fabricante
mathematical: matemático
mathematician: matemático
mathematics: matemática
matrix: matriz
matter: matéria
mattress: colchão
mature: maduro
Mauritania: Mauritânia
maximum: máximo, maximo
may: possa
May: Maio
maybe: talvez, acaso
me: mim
meadow: prado
meal: refeição
mealies: milho
mean: meio, tencionar
meaningless: sem sentido
means: significa, ferramenta
meanwhile: entrementes
measles: sarampo
measure: medida
measured: medido
measurement: medida
meat: carne
mechanic: mecânico
mechanical: mecânico
mechanics: mecânica
medal: medalha
medical: médico
medicine: medicina
Mediterranean: Mediterrâneo
meet: reunião
meeting: reunião
melancholy: melancolia
melody: melodia
melon: melão
melt: derretimento
melting: derretimento
member: membro
membership: sociedade
memory: memória
menace: ameaça
mend: emende
menu: lista
merchandise: mercadoria
merchant: comerciante
Mercury: Mercúrio
mere: mero
merit: mérito
merry: alegre
mesh: engranzamento
message: mensagem
messenger: mensageiro
metal: metal
metallic: metálico
meteorology: meteorologia
meter: medidor
method: método
methodical: metódico
metre: medidor
metric: métrico
Mexican: Mexicano
Mexico: México
microbe: micróbio
microfilm: microfilme
microphone: microfone
microscope: microscópio
midday: meio-dia
midday meal: almoço
middle: médio
Middle East: Médio-Oriente
midge-bite: midge-mordida
midget: anão
midnight: meia-noite
migrant: emigrante
migrate: migre
mild: suave
mile: milha
milestone: marco miliário
military: militar
milk: leite
mill: moinho
miller: moleiro
millimeter: milímetro
millimetre: milímetro
milliner: modista
million: milhão
mind: mente, observar
mine: mina
miner: mineiro
minimum: mínimo
mining: mineração
mining-engineer: mining-coordenador
minister: ministro
ministry: ministério
mint: hortelã
mint-master: mint-mestre
minus: negativo
minute: minuto
minutes: minutos
mirror: espelho
miscarry: fracasse
miserable: miserável, pobre, mau
miserably: miserável
misery: miséria
misfortune: infortúnio
miss: falta
mission: missão
missionary: missionário
mist: neblina, névoa
mistake: erro, defeito
mistaken: confundido
misunderstand: entenda mal
misunderstanding: engano
mite: ácaro
miter: mitras
mitre: mitra
mitten: luva
mix: mistura
mixture: mistura
mnemonic: mnemônica
mobile: móbil, móvel
mode: modo, modalidade, moda, maneira
model: modelo
moderate: moderado
modern: moderno
modest: modesto
modify: modifique
moist: úmido
moisture: umidade
mold: molde
mole: toupeira
molecule: molécula
moment: momento
momentarily: momentaneamente
momentary: momentâneo
Monday: Segunda-feira
money: dinheiro
money-box: dinheiro-caixa
monkey: macaco
monkey-like: macaco-como
monkey-wrench: macaco-chave
monopoly: monopólio
month: mês
monthly: mensal, mensalmente
monument: monumento
mood: modo
moon: lua
moon-: lua
moonlight: luar
Moor: Amarre
moose: alces
morality: virtude
morals: morais
more: mais
moreover: além disso, demais
morning: manhã
Morocco: Marrocos
morpheme: morfema
morphology: morfologia
mortar: almofariz
Moscow: Moscovo, Moscou
Moslem: Muçulmanos
mosquito: mosquito
mosquito-net: mosquito-rede
mosquito-netting: mosquito-rede
moss: musgo
moss-green: musgo-verde
most: a maioria
mostly: na maior parte, mormente
moth: traça
mother: mãe
motion: movimento
motive: motivo, motriz
motor: motor
motor-launch: motor-lanche
motorcycle: motocicleta
mould: molde
mount: montagem
mountain: serra, montanha
mounting: montagem
mouse: rato
mouse-trap: rato-prenda, ratoeira
moustache: bigode
mouth: boca, foz
move: movimento
movement: movimento
movie: filme
moving: mover-se
Mr: Sr.
Mr.: Sr.
much: muito
muck-water: muck-água
mud: lama, lodo
muddy: enlameado
mulberry-tree: amoreira, mulberry-árvore
mule: mula
multinational: multinacional
multiple: múltiplo
multiply: multiplique
murder: assassinato
muscle: músculo
museum: museu
mushroom: cogumelo
music: música
music-book: música-livro
music-box: música-caixa
music-lesson: música-lição
music-lover: música-amante
music-stand: música-esteja
musical-box: musical-caixa
musician: músico
musk-deer: musk-cervos
musk-ox: musk-boi
Muslim: Muçulmanos
mussel: mexilhão
mussel-bank: mexilhão-banco
mussel-bed: mexilhão-cama
must: obrigação
mustard: mostarda
mustard-gas: mostarda-gás
muster-roll: agrup-role
mutton: carne de carneiro
mutual: mútuo
muzzle: açaime
my: meu
myriad: miríade
myself: eu mesmo
mysterious: misterioso
mystery: mistério
myth : mito
nail: unha, prego
nail-bed: prego-cama
nail-brush: prego-escove
nail-scissors: prego-tesoura
nail-varnish: prego-envernize
naive: ingênuo
naked: despido, nu
name: nome
name-day: nome-dia
name-plate: placa de identificação
namely: a saber
Namibia: Namíbia
nap: sesta
napkin: guardanapo
Naples: Nápoles
narrative: narrativa
nasty: sujo, mau
nation: nação, povo
national: nacional
nationality: nacionalidade
native: nativo
naturally: naturalmente
nature: natureza, carácter
navigation: navegação
navy: marinha
near: perto
near-sighted: próximo-avistado
nearby: próximo
nearer: mais próximo
nearest: o mais próximo
nearly: quase
neat: puro
necessary: necessário, preciso
necessity: necessidade
neck: garganta, pescoço
necktie: gravata
nectar: néctar
need: necessidade
needle: alfinete, agulha
negative: negativo
negatively: negativamente
neglect: negligência
negotiate: negocie
neighbor: vizinho
neighborhood: vizinhança
neighbour: vizinho
neighbourhood: vizinhança
neither: nem, nenhuns
neon: néon
nephew: sobrinho
Neptune: Netuno
nerve: nervo
nervous: nervoso
nest: ninho
net: rede
network: rede
neutral: neutro
never: nunca, jamais
nevertheless: embora, não obstante, contudo
new: novo
news: notícia
newspaper: jornal
next: em seguida, próximo
nibble: mordidela
Nicaragua: Nicarágua
nice: agradável, bom
niece: sobrinha
Nigeria: Nigéria
night: noite
night-attire: noite-night-attire
night-blind: noite-cego
night-blindness: noite-night-blindness
night-duty: noite-dever
night-frost: noite-geada
night-lamp: noite-lâmpada
night-moth: noite-traça
night-service: noite-serviço
night-train: noite-treine
night-watch: noite-preste atenção
nightingale: rouxinol
Nile: Nilo
nine: nove
nineteen: dezenove, dazanove
ninth: nono
nip: estreitamento
nipple: bocal
nit-picker: nit-nit-picker
no: não, No.
no-one: ninguém
no-one's: no-one
noble: nobre
nobody: ninguém
nod: assentimento
node: nó
noise: ruído
noiseless: silencioso
noisy: ruidoso
none: nenhuns
nonsense: absurdo
noon: meio-dia
norm: norma
Norman: Normando
north: norte
North: norte
northern: do norte
Norway: Noruega
Norwegian: Norueguês
nose: nariz
nostril: narina
not: não
notary: notário
note: bilhete, nota
notebook: caderno
nothing: nada
notice: observação
notice-board: observação-placa
notification: notificação
notify: notifique
notion: noção
nought: zero
noun: substantivo
novel: novela, novo
November: Novembro
now: pois, agora, ora
nowadays: hoje em dia
nowhere: em nenhuma parte
nozzle: bocal
nucleus: núcleo
nude: nu
null: zero
number: número
nurse: enfermeira
nut: noz, porca
nuts : porcas
o'clock: horas
O.K.: APROVE.
oak: carvalho
oar: remo
oath: juramento
oats: aveia
obey: obedeça
object: objecto, objeto
objectionable: desagradável
obligation: obrigação
obliging: obrigar
obscure: obscuro
observation: observação
observe: observar
obstacle: obstáculo
obstruct: obstrua
obtain: adquirir, obter, obtenha
obtainable: obtenível
obvious: óbvio
obviously: obviamente, evidentemente
occasion: ocasião
occasional: ocasional
occupation: ocupação
occupy: ocupe, ocupar
occur: ocorra
ocean: oceano
October: Outubro
octopus: polvo
odd: impar
odour: odor
offensive: ofensivo
offer: oferta
office: escritório
officer: funcionário, oficial
official: funcionário, oficial
offset: distância
offspring: prole
often: freqüentemente
oil: óleo, azeite
OK: bem, APROVAÇÃO
okay: aprovação, bom, bem
old: velho
older: mais velho
olive: azeitona
olive-tree: azeitona-árvore, oliveira
omit: omita
omitted: omitido
on: em
on top: acima
once: uma vez que
one: um, uma
one-way traffic: mão-única
onerous: pesado
onion: cebola
only: somente, só
only just: apenas
open: aberto, abrir
open up: abrir
opening: abertura
openly: abertamente
opera: ópera
operate: funcionar, opere
operation: operação
operative: obreiro, operativo
opinion: opinião
Oporto: Porto
opponent: oponente
opportunity: oportunidade
oppose: oponha
opposite: oposto
opposition: oposição
optician: oculista
option: opção
or: ou
orally: oral
orange: laranja, alaranjado
orange-tree: laranjeira, alaranjado-árvore
orbit: órbita
orchard: pomar
order: ordem
ordinarily: ordinariamente
organ: órgão
organ-grinder: órgão-moedor
organic: orgânico
organism: organismo
organization: organização
orient: oriente
origin: origem
originally: originalmente
originate: origine
oscillate: oscile
oscillation: oscilação
oscillator: oscilador
oscilloscope: osciloscópio
ostrich: avestruz
other: outro
ounce: onça
our: nosso
ours: nossos
out: para fora de
outer: exterior
outfit: terno, equipamento, fato
outing: excursão
outline: esboço
output: saída
outside: fora
outstanding: proeminente
outward: para fora
oven: forno
over: sobre
over-: sobre
overall: total
overalls: macacões
overcoat: sobretudo
overdrive: ultrapassagem
overflowing: transbordar
overhaul: revisão
overhead: aéreo, acima
overlay: folha de prova
overlook: negligencie
override: ultrapassagem
overtake: alcance
overture: insinuação
overwhelm: oprima
owe: deva
owl: coruja, mocho
own: possuir, próprio, para possuir
owner: dono, proprietário
ownership: posse
ox: boi
oxygen: oxigênio
oyster: ostra
ozone : ozônio
pace: ritmo
Pacific: Pacífico
pack: embalar, bloco
package: pacote
packet: pacote
pad: almofada
paddle: pá
paddy-field: paddy-campo
page: página
pail: balde
pain: dor
painful: doloroso
paint: pintura
paintbrush: pincel
painter: pintor
painting: pintura
pair: par
pair of pincers: tenazes
Pakistan: Paquistão
palace: palácio
pale: pálido
Palestine: Palestina
palm: palma
pamphlet: panfleto
Pan: Bandeja
Panama: Panamá
pane: placa
panel: painel
panic: pânico
panther: pantera
panties: ceroulas, calcinhas
pantry: aparador, despensa
pants: calças
paper: papel
paper-basket: papel-cesta
parachute: pára-quedas
parade: parada
paradoxical: paradoxo
paraffin: parafina
paraffin-oil: petróleo, parafina-óleo
paragraph: parágrafo
Paraguay: Paraguai
parallel: paralela
paralyse: paralize
paralysed: paralizado
parameter: parâmetro
parcel: pacote
parent: pai
parenthesis: parêntese
parents: pais
parity: paridade
park: parque
parrot: papagaio
parsley: salsa
part: parte
partial: parcial
partially: parcialmente
participate: partícipe
particle: partícula
partition: divisória
partly: em parte
partridge: perdiz
party: partido
pass: passagem
pass away: morrer
passage: passagem
passenger: passageiro
passenger train: mixto
passer-by: transeunte
passion: paixão
passport: passaporte
past: após, além
paste: pasta
pastor: cura, sacerdote
patch: remendo
pate: cabeça
patent: patente
path: caminho, trajeto
patience: paciência
patient: paciente
patrol: patrulhe
pattern: teste padrão
pause: pausa
pave: pavimente
pavement: pavimento, passeio, calçada
paw: pé
pawn: penhor
pay: pagamento, pagar
pay out: gastar
payment: pagamento
pea: ervilha
peace: paz
peaceful: calmo
peach: pêssego
peak: pico
peanut: amendoim
pear: pera, pêra
pear-tree: pereira, pera-árvore
pearl: pérola
peasant: camponês
pedestal: suporte
peel: casca
peer: par
Peiping: Pequim
Peking: Pequim
pelvis: bacia, tejela
pen: pena
pen-knife: canivete
pencil: lápis
pending: pendente
penetrate: penetre
peninsula: península
penny: moeda de um centavo
pension: pensão
people: povo, povos
pepper: pimenta
per: por, em
percent: por cento
percentage: porcentagem
perfect: perfeito
perfection: perfeição
perform: aparecer, apresentar, fazer, execute
perhaps: acaso, talvez
peril: perigo
perimeter: perímetro
period: período
periodical: revista
peripheral: periférico
periphery: periferia
permanent: permanente
permission: permissão
permit: licença
Persian: Persa
persist: persista
persistent: persistente
person: pessoa
personal: próprio, pessoal
personality: carácter, personalidade
personnel: pessoal
persons: pessoas
perspiration: perspiração
persuade: persuada
pestle: pilão
pet: animal de estimação
petal: pétala
petition: petição
petrol: gasolina
petroleum: petróleo
phase: fase
phenomenon: fenômeno
Philippines: Filipinas
philosopher: filósofo
philosophy: filosofia
phoenix: fênix
phonetic: fonético
phonograph: fonógrafo
photograph: fotografia
photographer: fotógrafo
photography: fotografia
physical: físico
physician: médico
physics: física
pick: picareta
pick out: escolher
pick up: colher
picnic: piquenique
picture: retrato, quadro
picture-frame: retrato-frame
picturesque: pitoresco
pie: torta
piece: parte
piece of furniture: móvel
pier: cais
pig: porco
pigeon: pombo
pike: lúcio, pique
pile: pilha
pillar: coluna
pillow: almofada, descanso
pilot: piloto
pin: pino, alfinete
pincers: tenazes
pine: pinho, pinheiro
pine-apple: ananás, abacaxi
pine tree: pinheiro
pineapple: abacaxi, ananás
pink: cor-de-rosa
pioneer: pioneiro
pipe: cachimbo, tubulação
pirate: pirata
pistol: pistola
piston: pistão
pit: poço
pit-props: poço-suportes
pitcher: jarro
pity: piedade
pivot: pivô
placard: cartaz
place: meter, por, local, lugar, sítio, colocar
plague: praga
plain: planície, claro
plan: planta
plane: plano, plaina, avião
planet: planeta
planetary: planetário
plank: prancha
plant: planta
plantation: plantação
planting: plantar
plaster: emplastro
plastic: plástico
plate: placa
plateau: platô
platform: plataforma
platter: prato
play: jogo
plaza: praça, adro
pleasant: agradável
please: por favor, agradar
pleasing: satisfazer
pleasure: prazer
plot: conspiração, lote
plough: arado
pluck: arranque
plug: plugue
plum: ameixa
plumb: a prumo, prumo
plunder: roubar, pilhagem
plunge: mergulho
plus: positivo, mais
plywood: madeira compensada
pocket: algibeira, bolso
poem: poema
poet: poeta
poetic: poético
poetry: poesia
point: ponto
point out: mostrar
poison: veneno
poisonous: venenoso
Poland: Polônia, Polónia
Pole: polaco
pole: pólo
police: polícias
police-station: polícia-estação, delegacia
policeman: polícia
policy: política
polish: lustrador
polite: polido
political: político
politician: político
politics: política
pond: lagoa, lago
pony: pônei
poop: popa
poopdeck: popa
poor: mau, pobre
pope: papa
poplar: álamo
population: população
pork: carne de porco
port: porto
portable: portátil
portal: entrada
porter: carregador, porteiro
porthole: vigia
portrait: retrato
Portugal: Portugal
Portuguese: português
position: posição
positive: positivo
positively: positivamente
possess: possua, possuir
possession: possessão
possessions: possessões
possibility: possibilidade
possible: possível
possibly: acaso, possivelmente, talvez
post: borne, correio
post-paid: borne-pago
postage: porte postal, porte
postage stamp: selo
postman: carteiro
postulate: postulado
pot: potenciômetro, penico
pot-pourri: potenciômetro-pourri
potato: batata
pottery: cerâmica
poultry: aves domésticas
pound: libra
pound sterling: libra
pour: derrame
poverty: pobreza
powder: pó
power: poder
powerful: poderoso
practical: prático
practice: exercício, prática
practise: pratique
Prague: Praga
prairie: pradaria
praise: elogio
prawn: camarão grande
pre-fabrication: pré-fabricação
precede: preceda
precious: completamente
precise: preciso
precision: precisão
preface: prefácio
prefer: prefira, preferir
preferably: mais, preferivelmente
prefix: prefixo
pregnant: grávido
prejudice: preconceito
preliminary: preliminar
premium: superior
preparation: preparação
preparatory: preparatório
prepay: pague antecipadamente
preposition: preposição
prescription: prescrição
presence: presença
present: apresentar, presente
presentation: apresentação
president: presidente
press: imprensa
pressing: pressionar
prestigious: prestigioso
presume: presuma
presumption: presunção
pretend: finja
pretty: consideravelmente, lindo
prevent: impeça
previous: precedente
previously: previamente, antes, diante
price: preço
price-list: preço-lista
pride: orgulho
primary: preliminar
primitive: primitivo
prince: príncipe
princess: princesa
principle: princípio
print: cópia
printer: impressora
prior: previamente
prism: prisma
prison: cadeio, cadeia, prisão, prisno
prisoner: prisioneiro
private: confidencial
privilege: privilégio
privileged: privilegiado
prize: prêmio
probable: provável
probably: provavelmente
problem: problema
procedure: procedimento
proceed: prosiga
process: processo
procession: procissão
proclaim: proclame
procrastinate: procrastine
procure: obtenha
produce: produto, produza
producer: produtor
product: produto
production: produção
profess: professe
profession: profissão
professional: profissional
profile: perfil
profit: lucro
profound: profundo
program: programa
programme: programa
progress: progresso
prohibit: proíba
project: projeto
projector: projetor
proletarian: proletário
prolonged: prolongado
promise: promessa
promote: promova
prompt: alerta
prompter: mais alerta
promulgate: promulgue
pronounce: pronuncie
pronunciation: pronunciação
proof: prova
prop: suporte
propeller: hélice
proper: apropriado
properly: corretamente
property: fazenda, granja, propriedade
proportion: proporção
proportional: proporcional
proposal: proposta
propose: proponha
prose: prosa
prosperity: prosperidade
protect: proteja, proteger
protection: proteção
protein: proteína
protest: protesto
protocol: protocolo
prototype: protótipo
proud: orgulhoso
provide: forneça
provided that: se, si
province: província
provoke: provoque
prow: proa
proximity: proximidade
prune: ameixa seca
Prussia: Prússia
psychological: psicológico
psychologist: psicólogo
pub: taverna
public: público
public square: adro, praça
publication: publicação
publish: publique
publisher: editor
pudding: pudim
puff: sopro
pug-dog: pug-cão
pug-nose: pug-nariz
pull: puxar, tração
pulley: polia
pulsate: pulse
pulse: pulso
pump: bomba
pumpkin: abóbora
punch: perfurador
punctuation: pontuação
punish: puna
punishment: punição
puppet: fantoche
purchase: compra, comprar
pure: puro
purge: limpar, remoção
purple: roxo
purpose: alvo, finalidade
purse: bolsa
pursue: persiga
pursuit: perseguição
push: empurre, impulso
push-button: de botão de pressão
pussy: bichano
put: colocar, posto, meter, por
put down: por, meter, colocar
put up with: padecer
puzzle: enigma
pyramid: pirâmide
Pyrenees : Pirineus
quail: codornizes
qualification: qualificação
quality: qualidade
quantity: quantidade
quarrel: discussão
quarter: quarto
quarters: quartos
quay: plataforma
queen: rainha
question: pergunta
questionable: questionável
quick: rapidamente, rápido
quickly: rapidamente, depressa
quietly: quietamente
quit: parado
quotation: citação
quotation mark: aspas
quote: cota, cite
quotes : citações
rabbit: coelho
race: raça
radiator: radiador
radically: radical
radio: rádio
radish: rábano
radius: raio
raft: jangada
rag: pano
ragout: guisado
rail: trilho
railroad: estrada de ferro, ferrovia
railway: ferrovia, via férrea
railway carriage: vagão, carruagem
rain: chover, chuva
rainbow: arco-íris
raincoat: impermeável
raise: aumento
rake: ancinho
ranch: rancho, fazenda, granja
rancher: rancheiro
rand: margem
random: aleatório
rank: fila
rapid: rápido
rare: raro
rasp: grosa
raspberry: framboesa
rat: rato
rat-poison: rato-veneno
rate: orçar, taxa, avaliar
rather: bastante
rational: racional
rattle: chocalho
raven: corvo
raw: cru
ray: raio
razor-blade: lâmina, lâmina de barbear
reach: alcance
react: reaja
reaction: reação
read: lido, ler
reader: leitor
ready: pronto
realise: realize, compreenda
reality: realidade
really: deveras, realmente, verdadeiramente
realm: reino
rear: parte traseira
rear-lamp: traseiro-lâmpada
rear-light: traseiro-luz
reason: razão, causa
reasonable: razoável
rebellion: rebelião
recall: recordação
receipt: recibo
receive: receba, receber, aceitar
recent: recente
recently: recentemente
reception-room: recepção-quarto
recess: rebaixo
recipe: receita
recipient: receptor, destinatário
reciprocal: recíproco
reclaim: recuperação
recognise: reconheça
recognize: reconheça
recollect: recorde
recommend: recomende
recommendation: recomendação
recommended: recomendado
record: registar, registro
records: registros
recover: recupere
recruit: recruta
red: vermelho
reduce: reduza
reed: lingüeta
reef: recife
reference: referência
refined: refinado
refinery: refinaria
reflect: refletir, reflita
reflection: reflexão
reform: reforma
refresh: refresque
refreshing: refrescante
refrigerator: refrigerador
refuge: refúgio
refusal: recusa
refuse: recusar, recuse
regard: respeito, consideração
region: região
register: registar, registo
registered: registrado
regret: pesar
regularly: regularmente
regulate: regule
regulation: regulamento
regulations: regulamentos
reign: reino
reject: rejeição, recusar
rejection: rejeção
relate: relacione
related: relacionado
relation: relação
relationship: relacionamento
relative: parente, relativo
relatively: relativamente
relax: relaxe
release: libere
relevance: relevância
reliable: de confiança
religion: religião
religious: religioso
relinquish: abandone
remain: ficar, remanesça
remainder: restante
remaining: restante
remark: observação
remarkable: notável
remedy: remédio
remember: recorde
remind: lembre
remittance: remessa
remote: remoto
remotely: remotamente
removable: removível
remove: remova
render: renda
renew: renove
rennet-stomach:rennet-estômago
renounce: renuncíe
renown: renomeado, reconhecido
rent: aluguel
repair: reparo
repay: reembolse
repayment: reembolso
repeat: repetir
repeatedly: repetidamente
repetition: repetição
replace: substitua
replacement: recolocação
reply: responder, resposta
report: relatório
repose: descansar
represent: represente
representation: representação
representative: representante
reproach: reprimenda
reproduce: reproduza
reproduction: reprodução
reptile: réptil
republic: república
republican: republicano
repulse: repulsa
reputation: reputação
request: rogar, pedido
require: requeira
requisition: requisição
rescue: poupar, salvamento
research: pesquisa
resemblance: semelhança
resemble: assemelhe-se
reserve: reserva
residence: residência
resign: renuncie
resignation: renúncia
resin: resina
resist: resista, resistir
resistance: resistência
resolution: definição
resonance-box: resonance-caixa
resources: recursos
respect: respeito
respectable: respeitável
respective: respectivo
respiration: respiração
respond: responda, responder
responsibility: responsabilidade
responsible: responsável
rest: descanso, descansar
restaurant: restaurante
resting-place: resting-lugar
restrain: reger, contenha
restrict: restrinja
restricted: restrito
result: resultado
retailer: varejista
retain: retenha
retardation: atraso
retarded: retardado
retire: aposente
retired: aposentado
retiree: aposentado
retirement: aposentadoria
retreat: recuo
return: retorno
return-ticket: bilhete de volta
reveal: revele
revenge: vingança
reverse: reverso
reversed: invertido
review: revisão
revise: revise, revisar
revolt: revolta
revolution: revolução
revolutionary: revolucionário
revolver: revólver
reward: recompensa
Rhine: Reno
Rhine-barge: Rhine-barca
Rhine-wine: Rhine-vinho
Rhodesia: Rodésia
rhyme: rima
rhythm: ritmo
rhythmic: rítmico
rib: reforço, costela
ribbon: fita
rice: arroz
rice-field: arroz-campo
rich: rico
rid: livrado
ride: passeio
rider: cavaleiro
rifle: espingarda
rig: equipamento
right: direita
right-hander: direito-hander, destro
rigid: rígido
rim: borda
ring: anel
rinse: enxaguadura
riot: motim
rip: rasgo
ripe: maduro
rise: ascensão
rising: levantar-se
risk: risco
river: rio
rivet: rebite
road: estrada
road-metal: estrada-metal
roam: vagueie
roar: rugido
rob: roubar
robber: salteador
robe: veste
robot: robô
rock: rocha
rocket: foguete
rod: haste
rodent: roedor
role: papel
roll: pãozinho, rolo
roller: rolo
roller-blind: persiana, rolo-cego
Roman: romano
Romania: Rumênia, Romênia
romantic: romântico
Rome: Roma
roof: telhado
room: quarto
rooster: galo
root: raiz
rope: corda
rose: levantou-se, rosa
rose-bush: levant-arbusto
rough: áspero, cru
round: redondo
route: estrada, rota
routine: rotina
row: fila, fileira, remar
row-boat: barco a remos
rowing-boat: rowing-barco
royal: real
rubber: borracha
rudder: leme
ruin: ruína
rule: reger, régua
ruler: régua
rules: réguas
Rumania: Rumênia, Romênia
ruminant: ruminante
rumor: boato
rumour: boato
run: funcionamento, funcionar
runner: corredor
rush: arremetidas
Russia: Rússia
Russian: russo
rust: oxidação
rusty: oxidado
rye : centeio
sacrifice: sacrifício
saddle: sela
safe: seguro
safety: segurança
safety-belt: cinto de segurança
safety-lamp: segurança-lâmpada
safety-pin: segurança-pino
sage: salva, sábio
Sahara: Saara
sailor: marinheiro
sake: causa
salad: salada
salary: salário
sale: venda
salmon: salmões, salmão
salt: sal
salute: saudação
same: mesmos
sample: amostra
sample-bottle: amostra-frasco
sample-card: amostra-cartão
sand: areia
sandwich: sanduíche
sandy: arenoso
sardine: sardinha
Sardinia: Sardenha
Sassenach: Inglês
satellite: satélite
satisfaction: satisfação
satisfactory: satisfatório
satisfied: satisfeito
satisfy: satisfaça
Saturn: Saturno
sauce: molho
saucepan: caçarola
saucer: pires
sausage: salsicha
savage: selvagem
save: excepto, poupar
saw: serra
say: dizer, palavra
scald: escalde
scale: escala, escama
scales: escalas
scan: varredura
Scandinavia: Escandinávia
Scandinavian: Escandinavo
scar: cicatriz
scarcely: apenas, mal
scene: cena
scenery: cenário
schedule: horário, programação
scheme: esquema
scholar: estudante
school: escola
science: ciência
scientific: científico
scientist: cientista
scissors: tesoura
score: contagem
Scot: escocês
Scotland: Escócia
Scotsman: escocês
scrap: sucata
scratch: risco
scream: grito
screech-owl: screech-coruja
screen: tela
screw: parafuso
screwdriver: chave de fenda
script: certificado
scythe: fouce, foice
sea: mar
sea-bottom: mar-fundo
seagull: gaivota
seal: selo, foca
seam: emenda
seamless: sem emenda
search: busca
seasickness: enjôo
seaside: costa
season: temporada, estação
seat: assento
second: em segundo
secondary: secundário
secondhand: de segunda mão
secret: segredo
secretary: secretária
section: seção
sector: setor
secure: seguro
security: segurança
seduce: seduza
see: ver, veja
seed: semente
seek: busca
seem: pareça
seize: apreenda
seldom: raramente
semantics: semântica
send: enviar, emita, mandar
sender: remetente
sense: sentido
sensitive: sensível
sentence: sentença
separate: separado, dividir
separation: separação
September: Setembro
septic: séptico
serial: de série
series: série
serious: sério, categorizado
serpent: serpente
servant: criada, empregado
serve: saque, servir
server: usuário
service: serviço
session: sessão
set: terno, fato, aparelho, jogo
setting: ajuste
settlement: estabelecimento
seven: sete
seventeen: dezessete, dazassete
seventh: sétimo
seventy: setenta
several: diversos
severe: severo
Seville: Sevilha
sewing-basket: sewing-cesta
sewing-box: sewing-caixa
sewing-class: sewing-classe
sewing-machine: sewing-máquina
sewing-things: sewing-coisas
sewing-thread: sewing-enfíe
sex: sexo, sex
shack: cabana
shade: máscara, sombra
shadow: sombra
shaft: eixo
shake: agitação
shall: deva
shallow: raso
shallowly: rasa
shape: forma
share: dividir, parte
share-capital: parte-importante
shareholder: acionista
shark: tubarão
sharp: afiado
sharp-toned: afiado-sharp-toned
sharpness: agudeza
shatter: fragmento
shaving-brush: shaving-escove
she: ela
shear: tesoura
shed: celeiro, vertente
sheep: ovelha, carneiros
sheet: folha, lençol
shelf: prateleira, tábua
shell: escudo
shelter: abrigo
shield: protetor, escudo
shift: deslocamento
shine: brilho, brilhar
shingle: telha
ship: navio
shirt: camisa
shiver: arrepio
shock: choque
shock-absorber: choc-absorvente
shoe: sapato, sapata
shoe-horn: calçadeira
shoe-lace: atacador, laço
shoe-lift: sapata-levante
shoemaker: sapateiro
shoot: tiro
shop: loja
shore: margem, costa
short: curto
shortage: falta
shorten: encurte
should: se
shoulder: ombro
show: mostra, mostrar
shower: chuveiro
shrill: agudo
shuffle: baralhamento
shut: fechar, fechado
shutter: obturador
shy: tímido
Siam: Sião
Siberia: Sibéria
Sicily: Sicília
sick: doente
side: lado, costado
side-issue: lado-edição
side-way: lado-maneira
sideboard: armário
sidewalk: passeio, calçada
sight: vista
sightseeing trip: excursão
sign: sinal, prova, aceno, subscrever
sign-board: sinal-placa
signal: sinal, aceno
signature: assinatura
significant: significativo
signify: signifique
silence: silêncio
silent: silencioso
silently: silenciosamente
silhouette: silhueta
silk: seda
sill: peitoril
silver: prata
silver-coloured: prata-colorido
similarity: similaridade
simple: simples
simplify: simplifique
simultaneous: simultâneo
since: desde
sing: cante, cantar
singer: cantora, cantador
singing-bird: pássaro canoro
single: único
singly: única
sink: dissipador
sister: irmã
sit: sente-se
site: local, sítio
sitting-room: sitting-quarto
situation: situação
six: seis
sixteen: dazasseis, dezesseis
sixth: sexto
sixtieth: sexagésimo
sixty: sessenta
size: tamanho
skate: patim
skeleton: esqueleto
sketch: esboço
ski: esqui
skid: patim
skillful: hábil
skin: pele
skirt: saia
skull: crânio
sky: céu
slab: laje
slanting: inclinar
slap: batida
slave: escravo
slay: matar
sleep: dormir, sono
sleeping-accomodation: sleeping-acomodação
sleeping-car: vagão-leito
sleeping-place: sleeping-lugar
sleeve: manga, luva
slender: delgado
slice: fatia
slip: deslizamento
slipper: deslizador
slope: inclinação
sloping: inclinar-se
slot: entalhe
Slovenian: Esloveno
slow: lento
slowly: lentamente
slug: lesma
small: pequeno
smart: esperto
smash: quebra
smear: mancha
smell: cheiro
smile: sorriso
smoke: fumo
smokers: fumantes, fumadores
smokestack: chaminé
smooth: liso
snail: caracol
snake: serpente
snore: ressono
snow: neve
so: tão, tais, tal, assim
soak: embeba
soap: sabão
socialism: socialismo
society: sociedade
sock: peúga
socks: meias (masc)
socket: soquete
Sofia: Sófia
soft: macio
soil: terra, solo
soiled: sujado, sujo
solder: solda
soldier: soldado
sole: planta, linguado, único
solely: unicamente
solid: contínuo
solo: de solo
solution: solução
Somalia: Somália
some: alguns, alguém
somebody: alguém
somehow: de algum modo
someone: alguém
something: algo
sometimes: às vezes
somewhere: em algum lugar
son: filho
song: canção
soon: cedo, logo
soot: fuligem
sophisticated: sofisticado
sort: sorte, gênero, espécie
soul: alma
sound: som, soar
soup: sopa
source: fonte, nascente
south: sul
southern: do sul
souvenir: lembrança
Soviet: Soviete
sow: porca
space: espaço
spade: pá
spades: pás
Spain: Espanha
Spaniard: Espanhol
Spanish: Espanhol
spanner: chave de boca
spare: sobressalentes
spark: faísca
sparrow: pardal
speak: fale, falar
special: especial
specially: especialmente
species: espécie
specific: específico
specify: especifique
specimen: espécime
spectacle: espetáculo
spectacles: espetáculos, óculos
spectator: espectador
speech: discurso
speed: velocidade
speedy: rápido
spell: período
spend: gaste, gastar
sphere: esfera
spider: aranha
spill: derramamento
spin: rotação
spinach: espinafre
spindle: eixo
spinning-wheel: spinning-roda
spiral: espiral
spirit: espírito
spirits: espíritos
spiritual: espiritual
spit: cuspo
splash: respingo
splinter: lasca
sponge: esponja
spongy: esponjoso
spontaneous: espontâneo
spool: carretel
spoon: colher
sporadic: esporádico
sport: esporte
spot: ponto, mancha, nódoa
spotless: sem mancha
spouse: esposo
spread: propagação
spring: nascente, primavera, mola
springtime: primavera
spur: dente reto
spurt: jorros
spy: espião
square: adro, praça, quadrado
squeeze: aperto
squirrel: esquilo
squirt: esguinche
stable: estábulo, estável
stack: pilha
staff: equipe de funcionários
stag: veado
stage: estágio
stage-manager: estágio-gerente
stain: mancha
stair: escada
stairs: escadas
stake: estaca
stale: velho
stall: estábulo, tenda
stammer: gaguejo
stamp: selo
stamp-collecting: carimb-stamp-collecting
stamped: carimbado
stand: celeiro, carrinho
standard: padrão
staple: grampo
star: estrela
starboard: estibordo
stare: olhar fixo
start: começar, começo, iniciar, princípio
starter: acionador de partida
state: estado
statement: indicação
station: estação
station-master: estação-mestre
stationer's shop: papelaria
statue: estátua
stay: ficar, estada
stay over: ficar
steal: roube
steam: vapor
steam-boiler: vapor-caldeira, caldeira
steel: aço
steep: íngreme
steer: boi
steering-wheel: steering-roda
stem: tronco, haste
stencil: estêncil
stenotypist: dactilógrafa, datilógrafa
step: etapa
step-father: padrasto
step-mother: madrasta
stepfather: padrasto
stepmother: madrasta
stern: popa
stew: guisado
stick: solfar, vara
sticker: etiqueta
sticky: pegajoso
stiff: duro
still: ainda
stimulate: estimule
stink: fedor
stinking: tresandar
stipulate: estipule
stipulation: estipulação
stir: agite
stitch: ponto
stock: estoque
Stockholm: Estocolmo
stocking: meia (fem)
stomach: estômago
stone: pedra
stone-chippings: pedra-stone-chippings
stone-dead: pedra-inoperante
stool: tamborete
stoop: incline
stop: paragem, parar, pare
stopper: bujão
store: loja
store-cupboard: armazen-armário, aparador
storey: andar
stork: cegonha
storm: tempestade
story: história, andar
stout: cerveja de malte
stove: fogão
stow: armazenagem
straight: em linha reta
straight past: além
straightforward: direto
strained: esticado
strainer: filtro
strait: estreito
strand: costa
strange: estranho
stranger: desconhecido
strangle: estrangule
strap: cinta
strategic: estratégico
strategy: estratégia
straw: palha
strawberry: morango
streak: raia
stream: córrego, corrente, ribeiro, riacho
streamlined: aerodinâmico
street: rua
street-corner: rua-canto, esquina
streetcar: bonde
strength: força
stress-mark: força-marca
stretcher: esticador
strict: estrito
strike: batida, bater
striking: golpear
string: corda
stringent: estrito
strip: tira
stripe: listra
stroke: curso
stroll: dê uma volta
stroller: carrinho de criança
strong: forte
structure: estrutura
struggle: esforço, pelejar
stub: topo
student: estudante
studio: estúdio
study: estudar, estudo
stuff: material
stuffing: encher
stumble: tropeço
sturdy: resistente
sty: chiqueiro, estábulo
style: estilo
stylus: estilete
subject: assunto
subjective: subjetivo
subjugate: subjugue
subjunctive: subjuntivo
submit: submeta
subordinate: subordinado
subscribe: subscreva
subscriber: subscritor
subscription: subscrição
subsequent: subseqüente
subsequently: subseqüentemente
subsidy: subsídio
substance: substância
substantive: substantivo
substitute: substituto
substitution: substituição
subtract: subtraia
subtraction: subtração
succeed: lograr, suceda
success: êxito, sucesso
successfully: com sucesso
successor: sucessor
such: tais
such as: como, quão
suck: sugue
Sudan: Sudão
sudden: repentino
suddenly: subitamente, de repente
suffer: sofra
suffice: baste
sufficient: suficiente
sufficiently: bastante, suficientemente
suffix: sufixo
suffocate: sufoque
sugar: açúcar
sugar-bowl: açúcar-bacia
sugar-palm: açúcar-palma
suggest: sugira
suggestion: sugestão
suit: terno, fato
suitable: apropriado
sulfur: enxôfre
sulfuric: sulfúrico
sulphur: enxôfre
sulphuric: sulfúrico
sum: soma
summarize: sumarie
summary: sumário
summer: verão
summer-house: verão-casa
summon: chame, chamar
summons: intimação
sun: sol
Sunday: Domingo
sunlight: luz solar
sunset: por do sol
sunshine: luz do sol
superimpose: sobreponha
supervise: supervisione
supper: ceia
supplementary: suplementar
supply: fonte
support: sustentação, apoio
suppose: suponha
suppress: suprima
sure: certo
surely: certamente
surface: superfície
surgeon: cirurgião
surgery: cirurgia
surgical: cirúrgico
surname: sobrenome
surplus: excesso
surprise: surpresa
surprising: surpreender
surrender: rendição
surround: cerque
surroundings: arredores
survive: sobreviva
suspect: suspeito
suspenders: suspensórios
suspicion: suspeita
sustain: sustente
sustained: sustentado
suture: sutura
swallow: andorinha
swan: cisne
swap: troca
sway: balanço
Swaziland: Suazilândia
swear: jure
sweat: suar, suor
Sweden: Suécia
Swedish: Sueco
sweep: varredura
sweet: doce
sweet-and-sour: agridoce
swell: inchamento
swelling: inchamento
swift: rápido
swiftly: rapidamente, depressa
swim: nadar, nadada
swimming-bath: natação-banho
swing: balanço
swirl: redemoinho
Swiss: Suíço
switch: interruptor
Switzerland: Suíça
sword: espada
syllable: sílaba
symbol: símbolo
symmetry: simetria
symptom: sintoma
syntax: sintaxe
syrup: xarope
system: sistema
systematic : sistemático
T-square: T-quadrado
table: tabela, mesa
tablet: tabuleta
tabulation: tabulação
tactic: tática
tactics: táticas
tad-pole: tad-pólo
Tagus: Tejo
tail: cauda
tailor: alfaiate, costureira, castuveira
tails: caudas
Taiwan: Formosa
take: aceitar, tomada, ocupar
take in: aceitar
take the place of: substituir
talk: falar, conversa
tall: alto
tame: doméstico
Tangier: Tânger
tank: tanque
Tanzania: Tanzânia
tap: torneira
tape: fita adesiva
tape-recorder: gravador de fita, registrador
tar: piche, alcatrão
tardy: tarde
task: tarefa
Tasmania: Tasmânia
taste: gosto
tattered: esfarrapado
tax: imposto
taxi: táxi
taxi-driver: motorista de táxi
tea: chá
tea-pot: bule
tea-towel: chá-toalha
teach: ensinar, ensine
teacher: professor, mestre, mestra
team: equipe
tear: lágrima, rasgo
tease: arrelíe
technical: técnico
technique: técnica
technology: tecnologia
teeth: dentes
telegram: telegrama
telegraph: telégrafo
telemetry: telemetria
telephone: telefone
telescope: telescópio
television: televisão
tell: diga, dizer
temper: têmpera
temperature: temperatura
tempest: tempestade
template: molde
temple: fontes
temporarily: temporariamente
temporary: provisório
ten: dez
tendency: tendência
tender: encarregado
tennis: tênis
tension: tensão
tent: barraca
tenth: décimo
term: termo
terminate: termine
terminology: terminologia
termite: térmita
terms: termos
terrain: terreno
terrible: terrível
terrify: estarreça
territory: território
terrorism: terrorismo
terrorist: terrorista
test: provar, esforço, teste, exame
text: texto
Thailand: Tailândia
Thames: Tamisa
than: do que
thank: agradeça, agradecer
thank you: obrigado
thanks: agradecimento, obrigado, agradecimentos
that: isso, quem
that much: tanto
that way: assim, tão, tal, tais
the: os, as, o
the day before yesterday: anteontem
the Far East: Extremo-Oriente
the Vatican: Vaticano
theatre: teatro
theft: roubo, furto
their: seu
theirs: deles
them: eles
theme: tema
then: então
theory: teoria
therapy: terapia
there: acolá, lá, aí, ali
there are: há
there is: há
thereafter: depois disso
therefore: conseqüentemente
thermometer: termômetro
thermostat: termostato
these: estes
they: eles
thick: gordo, densamente
thickness: espessura
thief: ladrão
thigh: coxa
thimble: dedal
thin: fino, delgado
thing: objeto, cousa, coisa
things: coisas
think: pense, pensar
thinking: pensamento
third: terceiro
thirst: sede
thirteen: treze
thirty: trinta
this: isto
thorn: espinho
those: aqueles
thou: tu
though: embora
thought: pensamento
thoughtful: pensativo
thousand: mil
thread: linha
threat: ameaça
threaten: ameace
three: três
threshold: ponto inicial
throat: garganta
through: pronto, através
throughout: durante todo
throw: lançar, atirar
thrust: pressão
thumb: polegar
thunder: trovão
Thursday: Quinta-feira
thus: assim, tais, tão, tal
Tibetan: Tibetano
tick: tique-taque
ticket: passagem, bilhete
ticket-window: bilhete-janela, bilheteria, bilheteira
tickle: cócegas
tide: maré
tidy: arrumado
tie: ligar, gravata, laço
tie up: ligar
tiger: tigre
tight: firmemente
tighten: aperte
tightly: firmemente
tile: telha
till: até
tilt: inclinação
timber: madeira
time: tempo
time-table: horário
timid: tímido
tin: estanho, lata
tinkle: tinido
tint: matiz
tiny: minúsculo
tip: ponta, gorjeta
title: título
to: a, para
to-day: hoje
toad: sapo
toast: brinde
tobacco: tabaco
tobacconist: tabacaria
today: hoje
toe: dedo do pé
together: junto
toilet: toalete, retrete, privada
toilet-paper: papel higiênico
token: aceno, prova, símbolo
tolerate: tolere
tolling: anunciar
tomato: tomate
tomato-soup: tomate-sopa
tomb: túmulo
tomorrow: amanhã
ton: tonelada
tone: tom
tongs: alicate
tongue: língua, linguagem, língua, lingüeta
tonight: hoje à noite
too: também, demasiado
tool: ferramenta
tooth: dente
top: alto
topic: tópico
topical: tópico
torch: tocha
torn: rasgado
tortoise: tartaruga
torture: tortura
toss: lance
touch: toque
touching: toque
tour: excursão
tourist: turista
tow: reboque
toward: a, para
towards: a, para
towel: toalha
tower: torre
towing-line: reboque-linha
town: vila, cidade
town-hall: cidade-salão
toy: brinquedo
trace: traço
track: trilha
tractor: trator
trade: transação, comércio
trading: negociar
tradition: tradição
traditional: tradicional
traffic: tráfego
tragedy: tragédia
tragic: trágico
trail: fuga
trailer: reboque
train: comboio, trem
trait: traço
tram: bonde
tramping: vagar
transaction: transação
transfer: transferência
transform: transforme
translate: traduza
translation: tradução
transmit: mandar, transmita, enviar
transport: transporte
transverse: transversal
trap: armadilha
travel: curso
traveler: viajante
traveller: viajante
tray: Bandeja
treacherous: traiçoeiro
tread: passo
treasure: tesouro
treat: deleite
treatment: tratamento
treaty: tratado
tree: árvore
tree-trunk: árvore-tronco, tronco
tremble: trema
trench: trincheira
trial: experimentação
triangle: triângulo
tribute: tributo
trick: truque
tricycle: triciclo
trigger: disparador
trim: guarnição
trip: desengate
triple: triplicar-se
triumph: triunfo
trolley: trole
troop: tropa
trot: trote
trouble: problema
troublesome: incômodo
trough: calha
trousers: calças
trout: truta
truck: caminhão
true: verdadeiro
truly: verdadeiramente
trumpet: trombeta
truncate: truncado
trunk: tronco, baú
trust: confiança
truth: verdade
try: provar, tentativa
tube: tubo, válvula
Tuesday: Terça-feira
tuft: topete
tug: puxar, rebocador, reboque
tugboat: rebocador
tummy: ventre
tuna: atum
tuna-fish: atum-peixes, atum
Tunis: Tunes
Tunisia: Tunísia
tunnel: túnel
tunny: atuns, atum
Turk: turco
turkey: peru
Turkey: Turquia
turn: fila, volta
turnip: nabo
Tuscany: Toscânia
TV: Tevê
Twelfth-day: dia de Reis
Twelfth-night: véspera do dia dos reis magos
twelve: doze
twenty: vinte
twenty-one: vinte e um
twice: duas vezes
twig: galho
twilight: crepúsculo
twins: gêmeos, gémeos
twist: torção
two: duas, dois
type: tipo
typewriter: máquina de escrever
typical: típico
typist: datilógrafo
tyre : pneumático
ugly: feio
Ukraine: Ucrânia
ultimately: finalmente
umbrella: guarda-chuva
umpire: árbitro
unanimous: unânime
uncle: tio
unclean: sujo
unconscious: inconsciente
uncouple: desacople
uncover: descubra
under: sob
underground: subterrâneo
underline: sublinhar
underneath: abaixo, debaixo de
underpants: ceroulas
understand: compreenda
understandable: compreensível
understanding: compreensão
undertake: empreenda
underwater: subaquático
undoubtedly: indubitàvelmente
unemployed: desempregado
unemployment: desemprego
unexpectedly: inesperadamente
unfortunate: infeliz
unfortunately: desgraçadamente, infelizmente
unhappy: infeliz
unhook: desenganche
uniform: farda, uniforme
unimportant: sem importância
unintentional: involuntário
union: união
unique: original
unit: unidade
unite: una
united: unido
unity: unidade
universe: universo
university: universidade
unknown: desconhecido
unless: a menos que
unload: descarregue
unlock: destrave
unmarried: solteiro
unoccupied: desocupado
unpack: desembale
unpleasant: desagradável
unseen: despercebido
unsound: doentio
untie: desate
until: até
unusual: incomun
up: acima de
up-to-date: moderno
upon: em cima
upper: superior
upset: virada
upstairs: acima
upwards: para cima
uranium: urânio
urban: urbano
urge: impulso
urgent: urgente
urgently: urgentemente
Uruguay: Uruguai
us: nós
USA: EUA
use: usar, uso, empregar
used: usado
useless: inútil
user: usuário
USSR: URSS
usually: geralmente
utility: utilidade
utopian: utópico
utter : total
vacant: vago
vacation: férias
vaccine: vacina
vacuum: vácuo
vacuum-cleaner: vácuo-líquido de limpeza
vacuum cleaner: aspirador
vain: vão
valid: válido
validate: valide
valley: vale
valuable: caro, valioso
value: valor
valve: válvula
van: camionete
vapour: vapor
variable: variável
varied: variado
variety: variedade
various: vário
varnish: verniz
vary: varie
vase: vaso
vast: vasto
Vatican: Vaticano
veal: vitela
vegetable: legume, vegetal
vegetarian: vegetariano
vegetation: vegetação
vehicle: veículo
veil: véu
vein: veia
velvet: veludo
Venice: Veneza
ventilate: ventile
ventilator: ventilador
venture: risco
verb: verbo
verify: verifique
verse: verso
version: versão
very: muito
vessel: embarcação, navio
vest: colete, veste
vibrate: vibre
vibration: vibração
vice: vício
vice-president: vice-presidente
vicinity: vizinhança
victim: vítima
victory: vitória
videotape: videotape, fita de vídeo
Vienna: Viena
view: vista
village: aldeia, vila
vine: videira, vinha
vinegar: vinagre
vineyard: vinhedo
violence: violência
violently: violentamente
violet: violeta
violin: violino
viper: víbora, cobra
virgin: virgem
virus: vírus
visa: visto
visible: visível
vision: visão
visit: visita
visitor: visitante
vitamin: vitamina
vocabulary: dicionário, vocabulário
void: vácuo
volcano: vulcão
volley: salva de palmas
voltage: tensão
voluntarily: voluntàriamente
voluntary: voluntário
volunteer: voluntário
vomit: vómito
vote: voto
vow: voto
vowel: vogal
voyage : viagem
wage: salário
wages: salários
waggon: vagão
wail: lamento
waist: cintura
waistcoat: colete
wait: esperar, espera
wait for: esperar
waiter: criado, empregado de mesa, garçon
waiting-room: waiting-quarto
wake: vigília
Wales: Gales
walk: caminhada
wall: parede, muro
wall-painting: parede-pintura
wall-tile: parede-telha
wallet: bolsa, carteira
walnut: noz
walnut-tree: noz-árvore, nogueira
wander: vagueie
want: anseio, queira
war: guerra
warehouse: armazém
warm: morno
warn: advirta
warning: aviso
warrant: autorização
Warsaw: Varsóvia
wash: lavagem, lavar
wasp: vespa
waste: desperdício
wasted: desperdiçado
watch: relógio
watchmaker: relojeiro
watchman: guarda
water: água
water-: água
water-bottle: água-frasco
water-buffalo: água-búfalo
water-closet: privada
water-colour: água-cor
water-melon: melancia
waterfall: cascata, cachoeira
wave: onda
wax: cera
way: estrada, modo, maneira
way out: saída
we: nós
weak: débil, fraco
weaken: enfraqueça-se
weakly: fraca
wealth: riqueza
wealthy: rico
weapon: arma
wear: desgaste, calçar
weary: cansado
weather: tempo
weaver-bird: weaver-pássaro
wedding: casamento
wedding-party: festa de casamento
wedge: cunha
Wednesday: Quarta-feira
weed: erva daninha
week: semana
week-end: fim de semana
weekly: semanalmente, semanal
weep: chorar
weigh: pese
weight: peso
weird: estranho
welcome: boa vinda
weld: solda
welder: soldador
well: bem, poço, pois
well-being: bem estar
well-off: rico
well then: pois
Welsh: Galês
West: oeste
west: oeste, ocidental
western: ocidental
wet: molhado
whale: baleia
wharf: cais, plataforma
what: que
whatever: o que quer que
wheat: trigo
wheel: roda
when: quando
where: onde
where ... to: aonde
where?: onde?
wherever: onde quer que
whether: se
which: qual, quem
which one: quem
while: durante, quando
whilst: durante
whip: chicote
whirl: giro
whisper: sussurro
whistle: assobie, assobiar
white: branco
who: quem
who?: quem?
whole: inteiro
wholesale: venda por atacado
whose: de quem
whose?: de quem?
why: porque
why?: por que?
wick: feltro de lubrificação
wide: largamente
widow: viúva
widower: viúvo
width: largura
wife: mulher, esposa
wild: selvagem
will: vontade
willing: querer
willingly: disposta, voluntariamente
willingness: voluntariedade
willow: salgueiro
win: ganhar, vitória
wind: vento
wind-instrument: vento-instrumento
window: bilheteria, janela, bilheteira
window-frame: janela-frame
window-glass: janela-vidro
wine: vinho
wing: asa
winged: voado
winter: inverno
wire: arame, fio
wisdom: sabedoria
wise: sábio
wish: desejar, querer, desejo, anseio
wit: sagacidade
witch: bruxa
with: com
withdraw: retire
withhold: retenha
within: em, dentro
without: sem
withstand: resistir
witness: testemunha
wolf: lobo
woman: mulher
woman-chaser: mulher-caçador
wonder: maravilha
wonderful: maravilhoso
wood: madeira
woodpecker: pica-pau
woods: madeiras, floresta
wool: lã, lãs
word: palavra
work: trabalhar, funcionar, trabalho
work-basket: trabalh-cesta
workbench: bancada
worker: trabalhador
workman: trabalhador
works: trabalhos
workshop: oficina
world: mundo
worm: sem-fim, bicho
worm-eaten: sem-fim-comido
worn: desgastado
worries: preocupa-se
worry: preocupação
worship: adoração
worth: valor
worthy: digno
wound: ferida
wounded: ferido
wrapper: envoltório
wrapping-paper: papel de embrulho
wreath: grinalda
wreathe: entreteça
wren: carriça
wrench: chave
wrest: mais wrest
wrinkle: enrugamento
wrist: pulso
wrist-watch: relógio, relógio de pulso
write: escrever, escreva
writer: escritor
writing: escrita
writing-desk: escrita-mesa, escritório
writing-paper: escrita-papel
writing-desk: escritório
written: escrito
wrong : erro
X-rays: Raios X
xerographic: xerográfico
xerography : xerografia
yard: jarda, pátio
yawn: bocejo
year: ano
yearly: anualmente
yearn: ansíe
yeast: fermento
yell: grito
yellow: amarelo
yes: sim
yesterday: ontem
yet: embora, já, contudo, ainda
yield: rendimento
yoke: garfo
yonder: aí, acolá, além, lá, ali
you: tu, você
young: jovem, novo
youngster: jovem
your: seu
yours: seu
yourself: você mesmo
youth: juventude
Yugoslav: Jugoslavo
Yugoslavia: Jugoslávia
Yugoslavian : Jugoslavo
Zambia: Zâmbia
zeal: zelo
zero: zero
zinc: zinco
zone: zona
zoo : jardim zoológico
